Comuna,Circuito,Establecimiento,Direccion_establecimiento,Latitud ,Longitud,Total Nacionales,Total Extranjeros,Total Mesas,COMUNA ID
COMUNA 1,1,ESC Nº26 HIPOLITO YRIGOYEN,SAN JUAN AV 353,-34.621695,-58.370297,5,6,11,001
COMUNA 1,1,INST MARIA AUXILIADORA,AV JUAN DE GARAY 556,-34.62447,-58.373527,6,0,6,001
COMUNA 1,1,ESC Nº3 BERNARDINO RIVADAVIA,BOLIVAR 1235,-34.622408,-58.372816,7,0,7,001
COMUNA 1,1,ESC INTEGRAL INTERDISCIPLINARIA Nº3,PIEDRAS 1430,-34.625351,-58.376601,4,0,4,001
COMUNA 1,1,ESC Nº27 DEAN FUNES,DEFENSA 1431,-34.624632,-58.371202,3,0,3,001
COMUNA 1,1,ESC N°4 BALDOMERO FERNANDEZ MORENO,PERU 1357,-34.623885,-58.374131,5,0,5,001
COMUNA 1,2,ESC Nº21 HIPOLITO VIEYTES,PERU 946,-34.619002,-58.374306,5,0,5,001
COMUNA 1,2,ESC Nº1 VALENTIN GOMEZ,INDEPENDENCIA AV 758,-34.617497,-58.376777,5,9,14,001
COMUNA 1,2,ESC N°22 DR GUILLERMO RAWSON,HUMBERTO PRIMO 343,-34.620669,-58.370594,4,0,4,001
COMUNA 1,2,COLEGIO Nº7 J M PUEYRREDON,CHACABUCO 922,-34.618783,-58.375842,5,0,5,001
COMUNA 1,2,JARDIN DE INFANTES N°3 SAN TELMO,PIEDRAS 860,-34.618102,-58.377292,4,0,4,001
COMUNA 1,2,UBA - FACULTAD DE INGENIERIA,PASEO COLON AV 850,-34.617777,-58.368758,5,0,5,001
COMUNA 1,3,UCA - EDIFICIO SANTO TOMAS MORO,MOREAU DE JUSTO ALICIA AV 1400,-34.614458,-58.366053,9,1,10,001
COMUNA 1,4,UCA - EDIFICIO SAN ALBERTO MAGNO,MOREAU DE JUSTO ALICIA AV 1500,-34.615719,-58.365905,8,2,10,001
COMUNA 1,5,ESC Nº25 BANDERA ARGENTINA,LETONIA Y COMBATE DE COSTA BRAVA,-34.588113,-58.370077,10,14,24,001
COMUNA 1,5,ESC Nº6 PADRE C MUGICA,LETONIA 1940,-34.587586,-58.370083,8,6,14,001
COMUNA 1,5,ESC INFANTIL N°5,LETONIA 1928,-34.587586,-58.370083,11,10,21,001
COMUNA 1,5,ESC NAC DE NAUTICA MANUEL BELGRANO,ANTARTIDA ARGENTINA AV 1535,-34.583316,-58.372988,4,12,16,001
COMUNA 1,6,INST EN LENGUAS VIVAS J R FERNANDEZ,CARLOS PELLEGRINI 1515,-34.590316,-58.381308,3,4,7,001
COMUNA 1,6,ESC Nº2 D F SARMIENTO,QUINTANA MANUEL PTE AV 31,-34.592325,-58.384891,13,8,21,001
COMUNA 1,6,JARDIN DE INFANTES N°4 CINCO ESQUINAS,QUINTANA MANUEL PTE AV 7,-34.592579,-58.38457,9,0,9,001
COMUNA 1,6,COLEGIO Nº2 D F SARMIENTO,LIBERTAD 1257,-34.593569,-58.384408,6,7,13,001
COMUNA 1,6,INSTITUTO MALLINCKRODT,JUNCAL 1160,-34.592867,-58.383779,6,0,6,001
COMUNA 1,6,COLEGIO JESUS MARIA PRIMARIA,URUGUAY 1241,-34.593893,-58.387367,3,0,3,001
COMUNA 1,6,ASOCIACION ARGENTINA DE CULTURA INGLESA,SUIPACHA 1333,-34.592179,-58.380072,4,0,4,001
COMUNA 1,7,USAL FACULTAD DE PSICOLOGIA,M T DE ALVEAR 1335,-34.596957,-58.386208,9,5,14,001
COMUNA 1,7,UCES,PARAGUAY 1318,-34.598233,-58.385895,4,0,4,001
COMUNA 1,7,INST C RAMOS MEJIA DE BUNGE,PARAGUAY 1252,-34.598149,-58.384749,10,0,10,001
COMUNA 1,8,ESC Nº6 FRENCH Y BERUTI,BASAVILBASO 1295,-34.593125,-58.377155,10,4,14,001
COMUNA 1,8,JARDIN DE INFANTES INTEGRAL N°2,JUNCAL 690,-34.592962,-58.37684,7,0,7,001
COMUNA 1,8,COLEGIO DE NUESTRA SEÑORA,ESMERALDA 759,-34.599376,-58.378219,7,5,12,001
COMUNA 1,9,ESC Nº4 DE CATEDRAL J M ESTRADA,RECONQUISTA 461,-34.602443,-58.372473,4,8,12,001
COMUNA 1,9,ESC Nº13 GRAL SAN MARTIN,SAN MARTIN 458,-34.602665,-58.373923,5,9,14,001
COMUNA 1,9,CIRCULO POLICIA FEDERAL - SEDE SOCIAL,SAN MARTIN 353,-34.603799,-58.373791,3,0,3,001
COMUNA 1,9,BOLSA DE COMERCIO DE BUENOS AIRES,25 DE MAYO 359,-34.603529,-58.371026,10,0,10,001
COMUNA 1,9,CENTRO CULTURAL KIRCHNER,ALEM LEANDRO N AV 339,-34.603617,-58.369797,10,0,10,001
COMUNA 1,10,ESC Nº5 RODRIGUEZ PEÑA,RODRIGUEZ PENA 747,-34.60037,-58.391425,4,8,12,001
COMUNA 1,10,INST LIBRE DE SEGUNDA ENSEÑANZA,LIBERTAD 555,-34.602028,-58.38378,3,0,3,001
COMUNA 1,10,UMSA,CORRIENTES AV 1723,-34.604284,-58.391316,4,0,4,001
COMUNA 1,10,ESC Nº7 PRESIDENTE ROCA,LIBERTAD 581,-34.601733,-58.383799,5,0,5,001
COMUNA 1,10,ESC Nº19 ALEJANDRO VOLTA,RODRIGUEZ PENA 551,-34.602526,-58.391195,8,0,8,001
COMUNA 1,10,ESC Nº8 NICOLAS AVELLANEDA,TALCAHUANO 680,-34.600817,-58.385428,4,0,4,001
COMUNA 1,10,COLEGIO PUBLICO DE ABOGADOS,CORRIENTES AV 1441,-34.604039,-58.387128,4,0,4,001
COMUNA 1,11,UMSA FACULTAD DE ARTES,SARMIENTO 1565,-34.605386,-58.388833,3,6,9,001
COMUNA 1,11,COMPLEJO TEATRO SAN MARTIN,CORRIENTES AV 1530,-34.604241,-58.388642,7,0,7,001
COMUNA 1,11,CLUB GEBA - SEDE ALDAO,BARTOLOME MITRE 1149,-34.607373,-58.382965,8,0,8,001
COMUNA 1,11,ESC Nº9 FAMILIA DE CABEZON,TTE GRAL PERON 1140,-34.606202,-58.382646,9,0,9,001
COMUNA 1,11,INST SANTA ROSA,BARTOLOME MITRE 1655,-34.60783,-58.38993,8,6,14,001
COMUNA 1,12,COLEGIO DON BOSCO,SOLIS 252,-34.612123,-58.390322,15,0,15,001
COMUNA 1,12,COLEGIO SANTO TOMAS DE AQUINO,TTE GRAL PERON 1862,-34.606913,-58.393053,4,0,4,001
COMUNA 1,12,UNA DPTO DE CRITICA DEL ARTES,BARTOLOME MITRE 1869,-34.607998,-58.393019,12,0,12,001
COMUNA 1,13,UADE,INDEPENDENCIA AV 1127,-34.617609,-58.382026,4,4,8,001
COMUNA 1,13,INST NUESTRA SEÑORA DE MONTSERRAT,BELGRANO AV 1344,-34.613462,-58.385315,6,6,12,001
COMUNA 1,13,INST LOS ROBLES,LUIS SAENZ PENA 443,-34.614011,-58.387558,8,0,8,001
COMUNA 1,13,ESC Nº2 FRAY C RODRIGUEZ,CHILE 1670,-34.61681,-58.38999,4,0,4,001
COMUNA 1,13,ESC Nº14 GRAL MARIANO NECOCHEA,LUIS SAENZ PENA 463,-34.614198,-58.387556,9,3,12,001
COMUNA 1,13,ESC Nº13 PCIA DE SANTIAGO DEL ESTERO,CHILE 1371,-34.616631,-58.385514,4,0,4,001
COMUNA 1,14,INST PRIV CAMARA ARGENTINA DE COMERCIO,RIVADAVIA AV 970,-34.608381,-58.380183,3,0,3,001
COMUNA 1,14,COLEGIO NACIONAL DE BUENOS AIRES,BOLIVAR 263,-34.61099,-58.373447,8,5,13,001
COMUNA 1,14,INST NAC DE LA ADMINISTRACION PUBLICA,BELGRANO AV 637,-34.612606,-58.375291,4,0,4,001
COMUNA 1,15,ESC Nº4 CNEL ISIDORO SUAREZ,REPUBLICA BOLIVARIANA DE VENEZUELA 771,-34.613947,-58.377251,6,7,13,001
COMUNA 1,15,INST SUPERIOR OCTUBRE,REPUBLICA BOLIVARIANA DE VENEZUELA 356,-34.613626,-58.371344,3,0,3,001
COMUNA 1,15,UNIVERSIDAD ISALUD,REPUBLICA BOLIVARIANA DE VENEZUELA 931,-34.614097,-58.379454,3,0,3,001
COMUNA 1,15,UNIVERSIDAD ISALUD 2,REPUBLICA BOLIVARIANA DE VENEZUELA 847,-34.614015,-58.378281,3,0,3,001
COMUNA 1,15,ESC Nº3 SANCHEZ DE THOMPSON,TACUARI 567,-34.614844,-58.378978,9,0,9,001
COMUNA 1,16,ESC STA CATALINA DE ALEJANDRIA GIMNASIO,CASEROS AV 851,-34.627514,-58.376249,10,0,10,001
COMUNA 1,16,COLEGIO ESTEBAN ECHEVERRIA,SAN JUAN AV 961,-34.622035,-58.379419,4,0,4,001
COMUNA 1,16,INST FELICIA RAMON DE PALACIOS,BRASIL AV 882,-34.626768,-58.377059,6,6,12,001
COMUNA 1,16,INST SAN VICENTE DE PAUL,CARLOS CALVO 924,-34.619764,-58.379017,4,0,4,001
COMUNA 1,17,UBA FACULTAD DE CS SOCIALES,SAN JOSE 1064,-34.620631,-58.385798,7,0,7,001
COMUNA 1,17,ESC Nº7 GRAL GUEMES,CARLOS CALVO 1140,-34.619795,-58.382191,3,0,3,001
COMUNA 1,17,ESC Nº5 AGUSTIN ALVAREZ,HUMBERTO PRIMO 1573,-34.621308,-58.388258,5,4,9,001
COMUNA 1,17,COLEGIO INMACULADA CONCEPCION,CARLOS CALVO 1186,-34.6198,-58.382676,5,0,5,001
COMUNA 1,17,COLEGIO N°1 BERNARDINO RIVADAVIA,SAN JUAN AV 1545,-34.622417,-58.387802,6,5,11,001
COMUNA 1,17,UBA FACULTAD DE CIENCIAS SOCIALES,SANTIAGO DEL ESTERO 1029,-34.620242,-58.384407,8,9,17,001
COMUNA 1,18,ESC Nº16 EUSTAQUIO CARDENAS,SALTA 1226,-34.62252,-58.382918,5,3,8,001
COMUNA 1,18,COLEGIO DE LA PROVIDENCIA,COCHABAMBA 1414,-34.624024,-58.386423,8,0,8,001
COMUNA 1,18,ESC Nº11 DR RICARDO GUTIERREZ,LUIS SAENZ PENA 1215,-34.622683,-58.387229,4,5,9,001
COMUNA 1,18,INST LOS ANGELES - PRIMARIA,VIRREY CEVALLOS 1287,-34.623496,-58.388557,4,0,4,001
COMUNA 1,19,INST VOCACIONAL DE ARTE,GARAY JUAN DE AV 1684,-34.627274,-58.389142,4,0,4,001
COMUNA 1,19,ESC Nº6 TOMAS GUIDO,SAN JOSE 1985,-34.632181,-58.385514,4,6,10,001
COMUNA 1,19,ESC Nº4 CNEL DE MARINA T ESPORA,SOLIS 1815,-34.62937,-58.389313,10,0,10,001
COMUNA 1,19,JARDIN DE INFANTES WALT DISNEY,SAN JOSE 1980,-34.632051,-58.38542,3,0,3,001
COMUNA 1,19,INST LOS ANGELES - SECUNDARIA,ENTRE RIOS AV 1956,-34.630935,-58.390632,3,0,3,001
COMUNA 1,19,INST HOGAR DEL PINO,CONSTITUCION 1650,-34.62507,-58.389262,9,3,12,001
COMUNA 2,20,UBA - FACULTAD DE DERECHO,FIGUEROA ALCORTA AV 2263,-34.583292,-58.392374,20,3,23,002
COMUNA 2,20,ESC NACIONAL DE BIBLIOTECARIOS,AGUERO 2502,-34.584762,-58.397754,3,0,3,002
COMUNA 2,20,UBA FACULTAD DE DERECHO,FIGUEROA ALCORTA  AV 2263,-34.583292,-58.392374,10,4,14,002
COMUNA 2,21,ESC N°21 ANGEL GALLARDO,AYACUCHO 1849,-34.588833,-58.390486,7,0,7,002
COMUNA 2,21,INST NUESTRA SEÑORA DEL PILAR,VICENTE LOPEZ 1969,-34.58939,-58.392715,3,0,3,002
COMUNA 2,21,ESC N°1 JUAN JOSE CASTELLI,AYACUCHO 1680,-34.590237,-58.392186,18,2,20,002
COMUNA 2,22,ESC N°18 DR HERRERA VEGAS,LAS HERAS GRAL AV 3086,-34.58357,-58.405352,4,6,10,002
COMUNA 2,22,COLEGIO SAN TARSICIO,JUNCAL 2623,-34.590112,-58.403503,6,0,6,002
COMUNA 2,22,ESC N°24 CORNELIA PIZARRO,PENA 2670,-34.588078,-58.401675,9,0,9,002
COMUNA 2,22,ALIANZA FRANCESA CENTRO FORTABAT,BILLINGHURST 1926,-34.588533,-58.408676,5,0,5,002
COMUNA 2,22,INST MARIA BIANCHI DE COPELLO,PACHECO DE MELO 2455,-34.588021,-58.399282,8,0,8,002
COMUNA 2,22,ESC N°10 GREGORIA PEREZ,ARENALES 2733,-34.592139,-58.404587,13,0,13,002
COMUNA 2,23,INST SAN AGUSTIN,AGUERO 2320,-34.586305,-58.399969,12,8,20,002
COMUNA 2,23,INST SAN MIGUEL,LARREA 1254,-34.59252,-58.400244,8,0,8,002
COMUNA 2,23,COLEGIO RIO DE LA PLATA - SECUNDARIA,LAPRIDA 1635,-34.590873,-58.403878,4,2,6,002
COMUNA 2,23,INST PADRE ETCHEVERRY BONEO,JUNCAL 2131,-34.592727,-58.397831,4,0,4,002
COMUNA 2,23,COLEGIO SAN PABLO,PACHECO DE MELO 2300,-34.588772,-58.397535,5,0,5,002
COMUNA 2,23,LICEO NACIONAL N°1 J F ALCORTA,SANTA FE AV 2778,-34.592778,-58.405974,8,0,8,002
COMUNA 2,23,COLEGIO RIO DE LA PLATA - PRIMARIA,T M ANCHORENA 1644,-34.591371,-58.402943,3,0,3,002
COMUNA 2,23,INTERNATIONAL HOUSE BS AS,PACHECO DE MELO 2555,-34.587322,-58.400419,3,0,3,002
COMUNA 2,23,INST MERCEDES PACHECO,T M ANCHORENA 1553,-34.592109,-58.403652,9,0,9,002
COMUNA 2,23,UBA - FACULTAD DE INGENIERIA 2,LAS HERAS GRAL AV 2214,-34.588399,-58.396198,7,0,7,002
COMUNA 2,24,OAKHILL SCHOOL - SEDE RECOLETA,JUNCAL 1914,-34.593616,-58.394589,4,0,4,002
COMUNA 2,24,INST NTRA SEÑORA DE LA MISERICORDIA,AZCUENAGA 1630,-34.590136,-58.397175,15,5,20,002
COMUNA 2,24,COLEGIO LA ANUNCIATA,ARENALES 2065,-34.594496,-58.396497,10,0,10,002
COMUNA 2,25,ESC CARLOS PELLEGRINI,MARCELO T DE ALVEAR 1851,-34.597206,-58.393894,12,2,14,002
COMUNA 2,25,ESC INTEGRAL INTERDISCIPLINARIA N°1,AYACUCHO 953,-34.598036,-58.39595,10,0,10,002
COMUNA 2,25,ESC ARGENTINA MODELO,RIOBAMBA 1059,-34.596438,-58.394692,9,0,9,002
COMUNA 2,25,CASA DEL BICENTENARIO,RIOBAMBA 985,-34.597653,-58.394671,5,4,9,002
COMUNA 2,26,ESC N°3 ONESIMO LEGUIZAMON,AV SANTA FE 1510,-34.595851,-58.388627,16,2,18,002
COMUNA 2,26,INST DEL CARMEN,PARAGUAY 1706,-34.598702,-58.392243,9,0,9,002
COMUNA 2,26,COLEGIO CHAMPAGNAT,MONTEVIDEO 1046,-34.596612,-58.389908,8,0,8,002
COMUNA 2,26,INST INMACULADA C DE M ADORATRICES,URUGUAY 936,-34.597906,-58.387048,7,0,7,002
COMUNA 2,26,ESC INFANTIL N°7 PALACIO PIZZURNO,PARAGUAY 1452,-34.598365,-58.387637,3,2,5,002
COMUNA 2,26,USAL - FACULTAD DE MEDICINA,CORDOBA AV 1601,-34.599383,-58.390011,4,3,7,002
COMUNA 2,27,ESC N°1 R SAENZ PEÑA - SECUNDARIA,CORDOBA AV 1951,-34.599611,-58.395151,10,0,10,002
COMUNA 2,27,ESC N°1 R SAENZ PEÑA - PRIMARIA,PARAGUAY 1950,-34.598708,-58.395213,6,0,6,002
COMUNA 2,27,SEDE COMUNAL N°2,URIBURU JOSE EVARISTO PRES 1022,-34.596667,-58.398846,3,0,3,002
COMUNA 2,27,ESC N°23 BERNARDINO RIVADAVIA,LARREA 854,-34.598362,-58.402342,8,0,8,002
COMUNA 2,27,UBA - FACULTAD DE MEDICINA,PARAGUAY 2155,-34.598418,-58.398263,8,7,15,002
COMUNA 2,28,ESC N°2 JUAN LARREA,LAPRIDA 1235,-34.59451,-58.407621,14,0,14,002
COMUNA 2,28,COLEGIO EDMONDO DE AMICIS,N QUIRNO COSTA 1260,-34.595254,-58.405424,7,7,14,002
COMUNA 2,28,ESC N°6 MANUEL BELGRANO,ECUADOR 1158,-34.596603,-58.404905,11,7,18,002
COMUNA 2,28,ICAPA,T M ANCHORENA 1266,-34.594675,-58.406383,3,0,3,002
COMUNA 2,28,EL JARDIN DE PALERMO,CHARCAS 3082,-34.592839,-58.409479,3,0,3,002
COMUNA 2,28,INST LOS ANGELES CUSTODIOS,GRAL L N MANSILLA 2588,-34.596133,-58.404406,12,0,12,002
COMUNA 2,29,ESC N°13 REP DE IRAN,CABRERA JOSE ANTONIO 3484,-34.596769,-58.415348,5,2,7,002
COMUNA 2,29,COLEGIO ALETHEIA - GIMNASIO,GALLO 1353,-34.59451,-58.410592,8,0,8,002
COMUNA 2,29,INST EDUCATIVO GUIDO SPANO,BILLINGHURST 1355,-34.59434,-58.413171,4,0,4,002
COMUNA 2,29,INST VOCACIONAL ARGENTINO,CHARCAS 3034,-34.592964,-58.408877,10,4,14,002
COMUNA 2,29,UP - FACULTAD DE CS SOCIALES,MARIO BRAVO 1259,-34.595005,-58.414739,7,0,7,002
COMUNA 3,30,ESC N°8 DR ARTURO MATEO BAS,TUCUMAN 3233,-34.600328,-58.411616,5,10,15,003
COMUNA 3,30,ESC N°23 T M DE ANCHORENA,T M ANCHORENA 855,-34.598829,-58.408393,6,0,6,003
COMUNA 3,30,ESC N°24 PCIA DE CATAMARCA,JEAN JAURES 870,-34.600336,-58.407523,4,0,4,003
COMUNA 3,30,ESC N°14 JUAN MARTIN DE PUEYRREDON,BOULOGNE SUR MER 635,-34.602655,-58.406138,4,0,4,003
COMUNA 3,30,JARDIN DE INFANTES ESC Nº8,SAN LUIS 3224,-34.599389,-58.411439,4,0,4,003
COMUNA 3,30,UP - FACULTAD DE ARQUITECTURA,ECUADOR 931,-34.599061,-58.406004,5,0,5,003
COMUNA 3,30,UP - FACULTAD DE DISEÑO Y COMUNICACION,JEAN JAURES 932,-34.599101,-58.407069,4,0,4,003
COMUNA 3,31,UBA FACULTAD DE CS ECONOMICAS,CORDOBA AV 2150,-34.599824,-58.397929,7,5,12,003
COMUNA 3,31,ESC Nº10 PTE MANUEL QUINTANA,LAVALLE 2366,-34.603444,-58.400425,5,10,15,003
COMUNA 3,31,UBA - FAC DE CS ECONOMICAS,URIBURU JOSE EVARISTO PRES 781,-34.600011,-58.39871,8,6,14,003
COMUNA 3,31,INST TEA Y DEPORTEA,LAVALLE 2083,-34.603242,-58.396657,3,0,3,003
COMUNA 3,31,COLEGIO CORAZON DE JESUS,AYACUCHO 480,-34.60358,-58.395437,3,0,3,003
COMUNA 3,31,COLEGIO LA SALLE,RIOBAMBA 696,-34.601007,-58.394255,10,0,10,003
COMUNA 3,32,COLEGIO DEL SALVADOR,CALLAO AV 542,-34.602503,-58.392613,3,6,9,003
COMUNA 3,32,USAL FACULTAD DE FILOSOFIA,LAVALLE 1878,-34.603225,-58.393492,3,0,3,003
COMUNA 3,32,LICEO Nº7 D F SARMIENTO,CALLAO AV 450,-34.603798,-58.392439,3,0,3,003
COMUNA 3,32,ESC Nº2 DR ANTONIO BERMEJO,RIOBAMBA 623,-34.601661,-58.394096,3,0,3,003
COMUNA 3,32,POLIDEPORTIVO ESC N°2 A BERMEJO,CALLAO AV 628,-34.601623,-58.392753,5,0,5,003
COMUNA 3,32,COLEGIO PAULA MONTAL,VIAMONTE 1892,-34.600894,-58.39397,3,1,4,003
COMUNA 3,32,COLEGIO LA SALLE 2,TUCUMAN 1901,-34.602071,-58.394828,3,2,5,003
COMUNA 3,32,INST SAN LUIS GONZAGA,TTE GRAL PERON Y AYACUCHO,-34.607054,-58.395038,3,0,3,003
COMUNA 3,32,POLIDEPORTIVO CANGALLO SCHULE,TTE GRAL J D PERON 1953,-34.606938,-58.394174,5,0,5,003
COMUNA 3,33,ESC Nº16 PTE MITRE,SARMIENTO 2832,-34.60664,-58.406822,11,0,11,003
COMUNA 3,33,ESC Nº6 GRAL MARTIN RODRIGUEZ,T M ANCHORENA 441,-34.604779,-58.410595,5,6,11,003
COMUNA 3,33,COLEGIO Nº5 BARTOLOME MITRE,VALENTIN GOMEZ 3163,-34.605123,-58.410095,7,0,7,003
COMUNA 3,33,PARQUE DE LA ESTACION - ESCUELA ABIERTA,TTE GRAL PERON 3326,-34.607511,-58.413265,4,6,10,003
COMUNA 3,34,ESC CANGALLO SCHULE,TTE GRAL J D PERON 2169,-34.607178,-58.397449,7,6,13,003
COMUNA 3,34,UBA CENTRO DE IDIOMAS,JUNIN 224,-34.606804,-58.39655,7,0,7,003
COMUNA 3,34,ESC Nº14 CORNELIO SAAVEDRA,SARMIENTO 2250,-34.606077,-58.398664,9,0,9,003
COMUNA 3,34,INST ARGENTINO GALLEGO SANTIAGO APOSTOL,PASO 51,-34.609049,-58.403335,4,0,4,003
COMUNA 3,34,POLIDEPORTIVO PAULA MONTAL,BARTOLOME MITRE 2232,-34.608432,-58.398095,3,6,9,003
COMUNA 3,34,COLEGIO SAN JOSE,BARTOLOME MITRE 2455,-34.608561,-58.40146,10,6,16,003
COMUNA 3,35,UBA - FACULTAD DE PSICOLOGIA,H YRIGOYEN 3242,-34.61231,-58.412519,8,3,11,003
COMUNA 3,35,INST ARCANGEL SAN MIGUEL,T M ANCHORENA 41,-34.609904,-58.411709,7,5,12,003
COMUNA 3,35,ESC Nº2 MARIANO ACOSTA,GRAL URQUIZA 277,-34.613668,-58.409971,12,3,15,003
COMUNA 3,35,ESC Nº13 GRAL M ZAPIOLA,GRAL URQUIZA 227,-34.613061,-58.410064,8,0,8,003
COMUNA 3,36,ESC Nº5 PAUL GROUSSAC,CATAMARCA 462,-34.615375,-58.405984,5,6,11,003
COMUNA 3,36,ESC Nº12 REP DEL PARAGUAY,AGRELO 3231,-34.617888,-58.411717,7,0,7,003
COMUNA 3,36,INST 9 DE JULIO,LA RIOJA 660,-34.617506,-58.408075,7,0,7,003
COMUNA 3,36,UBA - FACULTAD DE PSICOLOGIA 2,INDEPENDENCIA AV 3065,-34.619829,-58.408762,5,0,5,003
COMUNA 3,37,LICEO Nº10 RICARDO ROJAS,JUJUY 150,-34.611856,-58.405606,6,0,6,003
COMUNA 3,37,CIRCULO DE SUBOFICIALES DE LA PFA,BELGRANO AV 2584,-34.614592,-58.40266,3,4,7,003
COMUNA 3,37,ESC Nº25 TTE 1 DE ARTILLERIA F L BELTRAN,JUJUY 780,-34.618335,-58.403582,9,0,9,003
COMUNA 3,37,ESC Nº6 DR GUILLERMO CORREA,SAAVEDRA 695,-34.617272,-58.402625,13,4,17,003
COMUNA 3,38,ESC Nº9 MARIANO MORENO,MORENO 2104,-34.613027,-58.396399,11,0,11,003
COMUNA 3,38,ESC Nº34 MONSEÑOR M D ANDREA,MORENO 2135,-34.612963,-58.396551,9,0,9,003
COMUNA 3,38,ESC Nº15 NARCISO DE LAPRIDA,MEXICO 2383,-34.616376,-58.399971,10,6,16,003
COMUNA 3,38,COLEGIO PROYECYO SUR,ALSINA ADOLFO 2185,-34.611803,-58.397099,5,3,8,003
COMUNA 3,39,COLEGIO ISABEL CONDE DE HERNANDEZ,MORENO 1859,-34.61269,-58.392605,4,0,4,003
COMUNA 3,39,INST DON ORIONE,H YRIGOYEN 2074,-34.610612,-58.395826,7,0,7,003
COMUNA 3,39,COLEGIO EUSKAL ECHEA - GIMNASIO,CHILE 2054,-34.617181,-58.395419,8,0,8,003
COMUNA 3,39,ESC Nº5 JOSE DE SAN MARTIN,AV ENTRE RIOS 751,-34.61752,-58.391793,9,6,15,003
COMUNA 3,39,COLEGIO EUSKAL ECHEA - JARDIN DE INFANTES,CHILE 2018,-34.617153,-58.395068,3,0,3,003
COMUNA 3,39,BIBILIOTECA DEL CONGRESO DE LA NACION,ALSINA ADOLFO 1835,-34.611509,-58.392455,6,2,8,003
COMUNA 3,40,INST SANTA CRUZ,24 DE NOVIEMBRE 950,-34.621938,-58.410645,5,4,9,003
COMUNA 3,40,ESC Nº11 JOSE FEDERICO MORENO,HUMBERTO PRIMO 3171,-34.623635,-58.410073,6,0,6,003
COMUNA 3,40,ESC Nº15 LUIS CHINETTI,ESTADOS UNIDOS 3141,-34.621326,-58.409753,4,0,4,003
COMUNA 3,40,ESC Nº7 OLEGARIO V ANDRADE,24 DE NOVIEMBRE 1536,-34.629116,-58.409886,3,0,3,003
COMUNA 3,40,ESC N°8 PTE JULIO A ROCA ANEXO,CARLOS CALVO 3150,-34.622598,-58.409833,3,0,3,003
COMUNA 3,40,ESC Nº9 DR. LUIS R MC KAY,CARLOS CALVO 3176,-34.622688,-58.410304,6,0,6,003
COMUNA 3,41,ESC Nº3 RUFINO SANCHEZ,LA RIOJA 850,-34.620279,-58.407637,9,3,12,003
COMUNA 3,41,ESC Nº8 PTE JULIO ARGENTINO ROCA,LA RIOJA 1042,-34.622605,-58.407243,7,0,7,003
COMUNA 3,41,ESC Nº17 LUIS JOSE CHORROARIN,CARLOS CALVO 2827,-34.621524,-58.404904,7,3,10,003
COMUNA 3,41,INST SAN CRISTOBAL,AV JUJUY 1241,-34.624466,-58.402128,8,0,8,003
COMUNA 3,41,ESC Nº10 FRANCISCO DE GURRUCHAGA,JUJUY 1471,-34.626975,-58.401538,3,0,3,003
COMUNA 3,41,ESC Nº11 MANUEL BELGRANO,COCHABAMBA 2830,-34.625688,-58.404594,8,6,14,003
COMUNA 3,41,ESC NUEVA ESPERANZA,GARAY JUAN DE AV 2715,-34.62879,-58.402757,3,0,3,003
COMUNA 3,41,JARDIN DE INFANTES INTEGRAL N°1,HUMBERTO PRIMO 2861,-34.622864,-58.405329,6,0,6,003
COMUNA 3,42,ESC Nº25 GERVASIO POSADAS,SAN JUAN AV 2277,-34.623082,-58.397317,7,4,11,003
COMUNA 3,42,ESC Nº21 CARLOS PELLEGRINI,ENTRE RIOS AV 1341,-34.624567,-58.391485,10,0,10,003
COMUNA 3,42,ESC Nº22 CARLOS PELLEGRINI,ENTRE RIOS AV 1359,-34.624709,-58.391473,10,2,12,003
COMUNA 3,42,ESC Nº23 GRAL VIAMONTE,PASCO 961,-34.620208,-58.397319,9,0,9,003
COMUNA 3,42,INST NTRA SRA DEL HUERTO,INDEPENDENCIA AV 2140,-34.618411,-58.396596,8,2,10,003
COMUNA 4,43,INST FELIX F BERNASCONI,CATULO CASTILLO 2750,-34.633454,-58.402298,14,0,14,004
COMUNA 4,43,INST NTRA SRA DE LUJAN,RONDEAU 2626,-34.634877,-58.399706,13,5,18,004
COMUNA 4,43,ESC N°26 BRIG M DE AZCUENAGA,PICHINCHA 1873,-34.63113,-58.39615,8,0,8,004
COMUNA 4,44,ESC N°11 RICARDO LEVENE,DEAN FUNES 1821,-34.632237,-58.404747,6,0,6,004
COMUNA 4,44,INST SAN VICENTE DE PAUL 2,24 DE NOVIEMBRE 1665,-34.630816,-58.409846,5,0,5,004
COMUNA 4,44,ESC N°2 JOSE MARIA GUTIERREZ,LA RIOJA 1846,-34.632499,-58.406087,7,4,11,004
COMUNA 4,44,CLUB BRISTOL,LA RIOJA 1869,-34.633005,-58.406089,4,0,4,004
COMUNA 4,44,CLUB ATLETICO HURACAN,CASEROS AV 3159,-34.637477,-58.40814,4,0,4,004
COMUNA 4,45,ESC N°2 PATRICIOS,ALMAFUERTE AV 66,-34.639059,-58.411611,4,4,8,004
COMUNA 4,45,ESC N°19 PCIA DE FORMOSA,ELIA 473,-34.643559,-58.408662,3,0,3,004
COMUNA 4,45,ESC DE RECUPERACION N°5,J A CORTEJARENA 3350,-34.644044,-58.409005,3,0,3,004
COMUNA 4,45,CLUB ATLETICO PIRAÑA,ELIA 678,-34.645358,-58.408203,4,0,4,004
COMUNA 4,45,CBO N°1 EVITA,LOS PATOS 3080,-34.641247,-58.405996,3,0,3,004
COMUNA 4,45,ESC N°28 ARGENTINA CHINA,LOS PATOS 3042,-34.641172,-58.405451,4,0,4,004
COMUNA 4,46,ESC N°7 D LAVALLE DE LAVALLE,ZAVALETA 204,-34.639764,-58.403069,6,0,6,004
COMUNA 4,46,ESC N°18 REINO DE SUECIA,JUAN C GOMEZ 253,-34.637207,-58.391109,4,0,4,004
COMUNA 4,46,ESC N°18 JUAN E PESTALOZZI,CASEROS AV 2152,-34.634754,-58.392866,4,0,4,004
COMUNA 4,46,INST LA INMACULADA,PATAGONES 2759,-34.637468,-58.401279,4,6,10,004
COMUNA 4,47,ESC N°11 REP DE HAITI,LAFAYETTE 1879,-34.65656,-58.390268,10,5,15,004
COMUNA 4,47,ESC N°10 ESTANISLAO DE ZAVALETA,IGUAZU 1110,-34.650031,-58.404914,9,18,27,004
COMUNA 4,47,INST SAGRADO CORAZON,CALIFORNIA 3018,-34.649695,-58.389445,10,7,17,004
COMUNA 4,47,ITBA SEDE PARQUE PATRICIOS,LOS PATOS 2802,-34.640141,-58.401399,11,6,17,004
COMUNA 4,47,INST NTRA SRA DEL BUEN CONSEJO,SANTA MARIA DEL BUEN AYRE 953,-34.654304,-58.381392,14,10,24,004
COMUNA 4,48,ESC N°8 CARLOS NORBERTO VERGARA,AMANCIO ALCORTA AV 1934,-34.639664,-58.388671,4,0,4,004
COMUNA 4,48,ESC N°28 FRANCISCO P MORENO,SALMUN FEIJOO 1073,-34.644074,-58.377727,4,0,4,004
COMUNA 4,48,ESC N°5 GRAL M MIGUEL DE GUEMES,ARCAMENDIA 743,-34.641244,-58.37997,9,0,9,004
COMUNA 4,48,ESC N°5 GRAL M MIGUEL DE GUEMES 2,ARCAMENDIA 793,-34.641243,-58.379965,3,0,3,004
COMUNA 4,48,CENTRO CENTES N°1,DR RAMON CARRILLO 317,-34.635586,-58.382139,4,0,4,004
COMUNA 4,48,ESC N°10 FRAY LUIS BELTRAN,VIEYTES 942,-34.643305,-58.379266,3,4,7,004
COMUNA 4,48,COLEGIO PARROQUIAL SANTA ELISA,SALTA 2290,-34.633856,-58.382466,6,0,6,004
COMUNA 4,48,INST SANTA MARIA DEL ROSARIO,HERRERA 575,-34.636335,-58.378316,8,0,8,004
COMUNA 4,49,ESC N°13 FRAY MAMERTO ESQUIU,SALOM 332,-34.64637,-58.382621,5,4,9,004
COMUNA 4,49,ESC N°24 PDTE DERQUI,CALIFORNIA 1925,-34.647271,-58.375672,6,0,6,004
COMUNA 4,49,JARDIN N°2 ANTONIO ABERESTAIN,SAN ANTONIO 1136,-34.655306,-58.375851,5,0,5,004
COMUNA 4,49,ESC N°27 MANUEL DE SARRATEA,VIEYTES 1469,-34.649727,-58.376923,4,0,4,004
COMUNA 4,49,ESC N°9 JOSE P VARELA,LUZURIAGA 1571,-34.653212,-58.387267,5,0,5,004
COMUNA 4,49,ESC N°20 NIEVES ESCALADA DE OROMI,SAN ANTONIO 682,-34.650123,-58.377779,6,0,6,004
COMUNA 4,49,CENTRO DE FORMACION PROFESIONAL N°1,RIO CUARTO 1993,-34.650104,-58.375638,4,0,4,004
COMUNA 4,50,ESC N°7 JUAN DE GARAY,CASEROS AV 734,-34.627123,-58.37497,6,4,10,004
COMUNA 4,50,ESC DE BELLAS ARTES M BELGRANO,WENCESLAO VILLAFANE 1342,-34.634834,-58.371734,10,0,10,004
COMUNA 4,50,ESC N°3 BERNARDO DE IRIGOYEN,MONTES DE OCA MANUEL AV 439,-34.633656,-58.375766,7,0,7,004
COMUNA 4,50,ESC N°4 REP DEL LIBANO,MONTES DE OCA MANUEL AV 121,-34.630203,-58.377139,6,0,6,004
COMUNA 4,50,ESC N°1 REP DE BOLIVIA,GRAL HORNOS 530,-34.633921,-58.377251,11,0,11,004
COMUNA 4,51,INST SANTA FELICITAS,PINZON 1480,-34.636905,-58.372352,4,3,7,004
COMUNA 4,51,INST ZACCARIA,MONTES DE OCA MANUEL AV 1844,-34.648529,-58.372603,11,0,11,004
COMUNA 4,51,ESC N°1 JOAQUIN V GONZALEZ,MONTES DE OCA MANUEL AV 1356,-34.643377,-58.373584,14,0,14,004
COMUNA 4,52,ESC N°3 JUAN MARTIN GUTIERREZ,ROCHA 1226,-34.641831,-58.367953,7,5,12,004
COMUNA 4,52,ESC N°4 JOSE JACINTO BERRUTTI,QUINQUELA MARTIN B 1081,-34.6424,-58.365536,3,0,3,004
COMUNA 4,52,ESC N°13 REP DE CHILE,SUAREZ 1145,-34.638107,-58.368585,16,0,16,004
COMUNA 4,52,ESC N°19 REPUBLICA ITALIANA,RIO CUARTO 1249,-34.647694,-58.367179,3,0,3,004
COMUNA 4,52,ESC N°11 ANTONIO J BUCICH,BRANDSEN 1057,-34.637085,-58.367698,6,0,6,004
COMUNA 4,53,ESC N°3 CASA AMARILLA,PALOS 210,-34.633369,-58.363639,6,11,17,004
COMUNA 4,53,ESC N°9 PEDRO DE MENDOZA,MENDOZA DON PEDRO DE AV 1835,-34.63908,-58.360936,4,0,4,004
COMUNA 4,53,ESC N°1 ALTE GUILLERMO BROWN,A DEL VALLE 471,-34.633204,-58.361336,6,0,6,004
COMUNA 4,53,ESC N°10 GRAL G ARAOZ DE LAMADRID,ARAOZ DE LAMADRID 499,-34.63744,-58.359237,4,0,4,004
COMUNA 4,53,ESC N°29 MANUEL BELGRANO,ARAOZ DE LAMADRID 676,-34.638521,-58.361731,3,0,3,004
COMUNA 4,53,ESC N°14 AGUSTIN R CAFFARENA,NECOCHEA 1136,-34.634283,-58.357763,6,0,6,004
COMUNA 4,53,ESC N°31 MAESTRO QUINQUELA,MENDOZA DON PEDRO DE AV 1777,-34.638947,-58.360144,6,0,6,004
COMUNA 4,53,COLEGIO SAN JUAN EVANGELISTA,ARAOZ DE LAMADRID 447,-34.637202,-58.358648,6,0,6,004
COMUNA 4,54,USINA DEL ARTE,AGUSTIN R CAFFARENA 1,-34.628692,-58.356101,4,8,12,004
COMUNA 4,54,ESC N°3 HTAL GRAL DE AGUDOS ARGERICH,AZOPARDO 1504,-34.626163,-58.366335,3,0,3,004
COMUNA 4,54,ESC N°8 CARLOS DELLA PENA,DR E BRAUN MENENDEZ 260,-34.627559,-58.362509,12,0,12,004
COMUNA 4,54,INST MADRE DE LOS EMIGRANTES,NECOCHEA 330,-34.628525,-58.36376,6,0,6,004
COMUNA 4,54,ESC N°2 DR CARLOS R VIGNALE,WENCESLAO VILLAFANE 453,-34.632399,-58.361882,4,0,4,004
COMUNA 4,54,ESC INTEGRAL INTERDISCIPLINARIA N°4,BROWN ALTE AV 473,-34.629756,-58.36458,6,0,6,004
COMUNA 4,54,CABJ POLIDEPORTIVO B QUINQUELA MARTIN ARZOBISPO,ESPINOSA ARZOBISPO 550,-34.631693,-58.365738,8,0,8,004
COMUNA 4,55,ESC N°24 CONTRALMTE MARTIN GUERRICO,LYNCH 3536,-34.651947,-58.409791,4,0,4,004
COMUNA 4,55,INST SAN VICENTE DE PAUL 3,A EINSTEIN 599,-34.651954,-58.412384,4,0,4,004
COMUNA 4,55,ESC N°23 DR LORENZO ANADON,TRAFUL 3847,-34.651732,-58.415064,3,0,3,004
COMUNA 4,55,ESC N°16 SABINA B DE BOZZALLA,AMANCIO ALCORTA AV 3402,-34.652292,-58.407602,4,0,4,004
COMUNA 4,55,COLEGIO NTRA SRA DE LA DIVINA PROVIDENCIA,CACHI 724,-34.651115,-58.411249,3,6,9,004
COMUNA 4,55,CLUB SOC Y DEP FRANJA DE ORO,AMANCIO ALCORTA AV 3950,-34.656077,-58.414494,3,0,3,004
COMUNA 4,55,ESC N°17 PEDRO MELITON LEDESMA,TRAFUL 3835,-34.651699,-58.414844,3,0,3,004
COMUNA 4,55,CLUB MIRIÑAQUE,LYNCH 3471,-34.651617,-58.408678,4,0,4,004
COMUNA 4,56,ESC N°2 DR GENARO SISTO,TILCARA 3365,-34.654745,-58.420409,3,0,3,004
COMUNA 4,56,INST SAN ANTONIO DE PADUA,TILCARA 3178,-34.65279,-58.418847,4,0,4,004
COMUNA 4,56,ESC N°33 F M DEL PLUMERILLO,RABANAL FRANCISCO INT AV 1573,-34.655975,-58.42091,4,0,4,004
COMUNA 4,56,ESC N°6 DR ADOLFO SALDIAS,ECHAURI 1576,-34.657286,-58.41743,4,0,4,004
COMUNA 4,56,ESC N°13 PTE ALBERTI,ITAQUI 2050,-34.653286,-58.431806,4,0,4,004
COMUNA 4,56,ESC N°3 PROF C J FORIT,TILCARA 2856,-34.64889,-58.422104,3,0,3,004
COMUNA 4,56,INST NUEVA POMPEYA,FOURNIER 3157,-34.652356,-58.417874,4,7,11,004
COMUNA 4,57,ESC N°5 PCIA DE CORRIENTES,CASEROS AV 4050,-34.639928,-58.421598,7,0,7,004
COMUNA 4,57,ESC N°14 PROV DE SAN LUIS,CACHI 77,-34.644215,-58.413162,9,9,18,004
COMUNA 4,57,ESC N°7 AERONAUTICA ARGENTINA,QUILMES 473,-34.644806,-58.417437,7,0,7,004
COMUNA 4,57,ESC N°1 MARIA SILVENTI DE AMATO,ALAGON 300,-34.643484,-58.421218,3,0,3,004
COMUNA 4,57,ESC N°10 HOMERO MANZI,A P ARBELETCHE 1052,-34.645699,-58.423738,6,0,6,004
COMUNA 4,57,JARDIN DE INFANTES INTEGRAL N°15 2,A FERREYRA 3705,-34.644612,-58.414132,6,0,6,004
COMUNA 4,57,ESC N°22 JUANA AZURDUY,MOM 2358,-34.646301,-58.432559,11,6,17,004
COMUNA 4,57,ESC N°21,A FERREYRA 3749,-34.64453,-58.414473,5,0,5,004
COMUNA 5,58,ESC N°20 E FERNANDEZ ALONSO,MUNIZ 2147,-34.639426,-58.422514,6,0,6,005
COMUNA 5,58,ESC N°8 ALMAFUERTE,MAZA 1913,-34.633873,-58.414471,4,6,10,005
COMUNA 5,58,ESC N°23 PCIA DE ENTRE RIOS,BOEDO AV 1935,-34.636569,-58.416302,9,0,9,005
COMUNA 5,58,ESC N°26 REP DE COLOMBIA,GARAY JUAN DE AV 3972,-34.631928,-58.420194,12,0,12,005
COMUNA 5,58,CASLA POLIDEPORTIVO ROBERTO PANDO,SALCEDO  Y JOSE MARMOL,-34.634703,-58.422216,10,0,10,005
COMUNA 5,58,INST MARIA AUXILIADORA 1,GARAY JUAN DE AV 4333,-34.63222,-58.424893,8,0,8,005
COMUNA 5,59,ESC N°25 PAULA A DE SARMIENTO,TARIJA 4136,-34.629805,-58.42254,5,0,5,005
COMUNA 5,59,ESC N°22 GUSTAVO MARTINEZ ZUVIRIA,CONSTITUCION 4154,-34.628984,-58.422919,5,0,5,005
COMUNA 5,59,ESC N°6 SAN JOSE DE CALAZANS,AV LA PLATA 1038,-34.627408,-58.426555,5,5,10,005
COMUNA 5,59,CLUB BUENOS AIRES SUR,COCHABAMBA 3650,-34.627083,-58.41674,8,0,8,005
COMUNA 5,59,POLIDEPORTIVO SPT,QUINTINO BOCAYUVA 1274,-34.628389,-58.420939,6,0,6,005
COMUNA 5,60,ESC N°14 INT ALVEAR,CASTRO 954,-34.623842,-58.42049,6,6,12,005
COMUNA 5,60,ESC N°29 RECONQUISTA DE BS AS,BOEDO AV 760,-34.621717,-58.416363,3,0,3,005
COMUNA 5,60,INSTITUTO MARIANO BOEDO,CASTRO BARROS 965,-34.623799,-58.419228,3,0,3,005
COMUNA 5,60,CLUB ESTRELLA DE BOEDO,CONSTITUCION 4151,-34.628894,-58.422969,16,0,16,005
COMUNA 5,60,FUNDACION NUEVA GENERACION DEL DEPORTE,QUINTINO BOCAYUVA 1241,-34.628287,-58.421084,17,0,17,005
COMUNA 5,61,JARDIN DE INFANTES CESAR COLL,H YRIGOYEN 4238,-34.615013,-58.426741,8,0,8,005
COMUNA 5,61,ESC N°16 JOSE M RAMOS MEJIA,DON BOSCO 4200,-34.613827,-58.424479,10,0,10,005
COMUNA 5,61,INST SAN ANTONIO,MEXICO 4050,-34.620327,-58.423329,6,0,6,005
COMUNA 5,61,INST DEL PROFESORADO SAGRADO CORAZON,LA PLATA AV 82,-34.616258,-58.428894,5,0,5,005
COMUNA 5,61,INST SAGRADO CORAZON 2,H YRIGOYEN 4350,-34.615166,-58.428257,10,0,10,005
COMUNA 5,61,FUNDACION GUTENBERG,BELGRANO AV 4299,-34.616002,-58.426948,4,5,9,005
COMUNA 5,62,ESC N°18 ANTONIO BERMEJO,BELGRANO AV 3767,-34.615742,-58.419573,10,2,12,005
COMUNA 5,62,ESC N°4 SALVADOR M DEL CARRIL,QUINTINO BOCAYUVA 620,-34.619209,-58.422385,8,0,8,005
COMUNA 5,62,ESC N°22 MARTINA GURRUCHAGA,BOEDO AV 657,-34.620589,-58.416629,11,3,14,005
COMUNA 5,63,INST SAN FRANCISCO DE SALES,H YRIGOYEN 3900,-34.614709,-58.420978,8,4,12,005
COMUNA 5,63,COLEGIO PIO IX,YAPEYU 197,-34.613939,-58.421886,12,5,17,005
COMUNA 5,63,ESEA DE CERAMICA N°1,BULNES 45,-34.610326,-58.418537,8,0,8,005
COMUNA 5,63,COLEGIO MARIA AUXILIADORA - GIMNASIO,CASTRO BARROS 175,-34.614001,-58.420516,14,0,14,005
COMUNA 5,63,INST SAN FRANCISCO DE SALES GIMNASIO,CASTRO BARROS 237,-34.61516,-58.420315,14,0,14,005
COMUNA 5,64,ESC N°18 ALEJANDRO CARBO,MARIO BRAVO 242,-34.607925,-58.417471,5,4,9,005
COMUNA 5,64,ESC N°22 CARLOS J BENIELLI,S DE BUSTAMANTE 260,-34.606295,-58.414939,7,0,7,005
COMUNA 5,64,ESC N°18 ALEJANDRO CARBO GIMNASIO,MARIO BRAVO 234,-34.607925,-58.417471,12,2,14,005
COMUNA 5,64,INST TIERRA SANTA,S DE BUSTAMANTE 124,-34.609077,-58.414655,16,8,24,005
COMUNA 5,64,COLEGIO NAC N°3 MARIANO MORENO,AV RIVADAVIA 3577,-34.610816,-58.416662,21,2,23,005
COMUNA 5,65,ESC N°19 FRANCISCO BALCARCE,ACUNA DE FIGUEROA 850,-34.601115,-58.422344,7,4,11,005
COMUNA 5,65,COLEGIO INMACULADA CONCEPCION 2,MARIO BRAVO 563,-34.602688,-58.41653,11,0,11,005
COMUNA 5,65,UTN SEDE MEDRANO,MEDRANO AV 951,-34.598788,-58.420249,10,0,10,005
COMUNA 5,65,INST WILLIAM MORRIS,LAVALLE 3761,-34.599624,-58.418643,4,1,5,005
COMUNA 5,65,ESC N°30 DR NORBERTO PIÑERO,J SALGUERO 920,-34.59885,-58.41904,3,5,8,005
COMUNA 5,65,INST NTRA SEÑORA DEL VALLE,SAN LUIS 3358,-34.599275,-58.412996,4,0,4,005
COMUNA 5,66,ESC N°7 JOSE MARIA TORRES,CORRIENTES AV 4261,-34.602769,-58.425041,11,0,11,005
COMUNA 5,66,COLEGIO BETANIA,ACUNA DE FIGUEROA  855,-34.601033,-58.422238,5,6,11,005
COMUNA 5,66,COLEGIO GALILEO GALILEI,ESTADO DE PALESTINA 748,-34.601967,-58.425591,6,0,6,005
COMUNA 5,66,ESC N°20 ROSARIO VERA PEÑALOZA,PRINGLES 1165,-34.598469,-58.426465,7,0,7,005
COMUNA 5,66,INST CASA DE JESUS,YATAY 869,-34.601766,-58.428431,9,0,9,005
COMUNA 5,67,ESC N°23 GRAL MANUEL BELGRANO,PRINGLES 263,-34.609464,-58.427579,15,4,19,005
COMUNA 5,67,INST BENITO NAZAR,ESTADO DE PALESTINA 1098,-34.597877,-58.424962,11,0,11,005
COMUNA 5,67,ESC N°3 MANUEL SOLA,LAMBARE 975,-34.603055,-58.430232,10,0,10,005
COMUNA 5,67,UNIVERSIDAD ARGENTINA J F KENNEDY,SARMIENTO 4550,-34.604116,-58.429639,3,0,3,005
COMUNA 5,67,INST NICHIA GAKUIN - SECUNDARIA,PRINGLES 268,-34.609391,-58.427682,3,0,3,005
COMUNA 5,67,INST NICHIA GAKUIN - PRIMARIA,YATAY 255,-34.609674,-58.429021,3,2,5,005
COMUNA 5,67,ESC N°11 PROV DE JUJUY,OBRERO R NUNEZ 4355,-34.603454,-58.426443,12,3,15,005
COMUNA 6,68,ESC Nº7 DEL CENTENARIO,RIO DE JANEIRO 986,-34.604391,-58.432036,6,7,13,006
COMUNA 6,68,ESC Nº17 PDTE URIBURU,GALLARDO ANGEL AV 246,-34.603883,-58.435563,8,0,8,006
COMUNA 6,68,ESC Nº15 GRAL J G DE ARTIGAS,ELEODORO LOBOS 437,-34.612843,-58.436312,7,0,7,006
COMUNA 6,68,ESC DEL NUEVO SOL,ARAOZ ALFARO 373,-34.615415,-58.436038,3,0,3,006
COMUNA 6,68,ESC DE LA PAZ,GRAL V FLORES 65,-34.61387,-58.431478,4,0,4,006
COMUNA 6,68,INST DIVINO ROSTRO,LEOPOLDO MARECHAL 1041,-34.60591,-58.439011,6,0,6,006
COMUNA 6,68,UNIVERSIDAD DE MORON,ARAOZ ALFARO 251,-34.614874,-58.43446,3,0,3,006
COMUNA 6,68,ESC SUP DE ENFERMERIA CECILIA GRIERSON,J B AMBROSETTI 601,-34.610174,-58.438379,3,0,3,006
COMUNA 6,68,CLUB PREMIER,CAMPICHUELO 472,-34.611906,-58.435204,4,0,4,006
COMUNA 6,68,UBA SEDE CBC PROF A J FERNANDEZ,RAMOS MEJIA 843,-34.605908,-58.432341,5,0,5,006
COMUNA 6,68,JARDIN DE INFANTES N°1 A FERREYRA,ACEVEDO 609,-34.596521,-58.438115,7,0,7,006
COMUNA 6,69,ESC Nº11 PTE M T ALVEAR,ALBERDI JUAN BAUTISTA AV 163,-34.622363,-58.430154,9,0,9,006
COMUNA 6,69,INST SANTA MARIA,SENILLOSA 568,-34.623092,-58.428981,8,0,8,006
COMUNA 6,69,ESC Nº3 PRIMERA JUNTA,AV RIVADAVIA 4817,-34.616711,-58.433097,6,0,6,006
COMUNA 6,69,ESC Nº9 FLORENTINO AMEGHINO,LA PLATA AV 623,-34.622682,-58.427789,5,0,5,006
COMUNA 6,69,ESC Nº19 J MONTALVO,FORMOSA 136,-34.620892,-58.430037,10,8,18,006
COMUNA 6,69,INST CALASANZ,BONIFACIO JOSE 56,-34.625869,-58.427659,8,0,8,006
COMUNA 6,69,INST SUMMA,YERBAL 57,-34.61454,-58.431305,6,0,6,006
COMUNA 6,69,JARDIN DE INFANTES N°2 MARGARITA RAVIOLI,CAMPICHUELO 100,-34.615644,-58.433399,10,0,10,006
COMUNA 6,69,CLUB ITALIANO,YERBAL 150,-34.615378,-58.432916,4,0,4,006
COMUNA 6,69,CLUB OESTE,MORENO JOSE MARIA AV 446,-34.623615,-58.434497,9,0,9,006
COMUNA 6,69,ESC Nº8 ANTONIO SCHETTINO,MORENO JOSE MARIA AV 480,-34.62391,-58.434464,7,0,7,006
COMUNA 6,70,INST ARGENTINO DEL DEPORTE,F GARCIA LORCA 350,-34.617957,-58.445535,8,0,8,006
COMUNA 6,70,ESC Nº20 TTE BENJAMIN MATIENZO,HIDALGO 635,-34.612386,-58.440505,4,0,4,006
COMUNA 6,70,ESC Nº14 ERNESTO PADILLA,F VALLESE 835,-34.613046,-58.445391,6,0,6,006
COMUNA 6,70,CLUB FERRO CARRIL OESTE 1,GRAL M DE GAINZA 270,-34.618465,-58.446547,9,0,9,006
COMUNA 6,70,CLUB FERRO CARRIL OESTE 2,GRAL M DE GAINZA 260,-34.618608,-58.44644,11,0,11,006
COMUNA 6,70,CLUB FERRO CARRIL OESTE 3,GRAL M DE GAINZA 250,-34.619059,-58.446355,10,0,10,006
COMUNA 6,70,ESC Nº9 ING LUIS A HUERGO,GRAL M DE GAINZA 1060,-34.608814,-58.446605,15,10,25,006
COMUNA 6,70,JARDIN DE INFANTES LA VELETA DE CABALLITO,HIDALGO 627,-34.612198,-58.440559,3,0,3,006
COMUNA 6,70,COLEGIO INTEGRAL CABALLITO,J F ARANGUREN 723,-34.614336,-58.442114,8,0,8,006
COMUNA 6,71,ESC Nº4 ESTANISLAO S ZEBALLOS,RIVADAVIA AV 4950,-34.617927,-58.435432,18,0,18,006
COMUNA 6,71,COLEGIO Nº17 PRIMERA JUNTA,RIVADAVIA AV 5161,-34.619082,-58.438427,16,0,16,006
COMUNA 6,71,LICEO Nº12 FRAY MAMERTO ESQUIU,MORENO JOSE MARIA AV 345,-34.622044,-58.435017,17,0,17,006
COMUNA 6,71,ESC Nº4 ORG DE ESTADOS AMERICANOS,DEL B CENTENERA 747,-34.6281,-58.440082,13,12,25,006
COMUNA 6,71,INST DR DAMASO CENTENO SECUNDARIA,RIVADAVIA AV 5558,-34.621661,-58.443615,8,0,8,006
COMUNA 6,71,ESC Nº14 JOAQUIN V GONZALEZ,AV PEDRO GOYENA 984,-34.626597,-58.44119,5,0,5,006
COMUNA 6,71,JARDIN DE INFANTES EL TRANVIA DE CABALLITO,DEL B CENTENERA 741,-34.6281,-58.440082,5,0,5,006
COMUNA 6,71,INST DR DAMASO CENTENO PRIMARIA,AV RIVADAVIA 5558,-34.621661,-58.443615,6,0,6,006
COMUNA 6,72,ESC Nº8 PCIA DE SAN JUAN,CNEL A FIGUEROA 1077,-34.609266,-58.452915,4,4,8,006
COMUNA 6,72,INST REDEMETRIX CAPTIVORUM,LUIS VIALE Y ESPINOSA,-34.608501,-58.453932,13,0,13,006
COMUNA 6,72,ESC Nº19 GALICIA,LUIS VIALE 1052,-34.608173,-58.453307,9,0,9,006
COMUNA 6,72,ESC Nº11 JOSE IGNACIO GORRITI,NICASIO ORONO 1429,-34.60893,-58.4583,5,0,5,006
COMUNA 6,72,JARDIN DE INFANTES N°4,ESPINOSA 1243,-34.608968,-58.453509,3,0,3,006
COMUNA 6,72,CIRCULO ITALO ARGENTINO LIBER PIEMONT,GRAL M A RODRIGUEZ 1191,-34.607685,-58.448289,5,0,5,006
COMUNA 6,73,INST SANTA BRIGIDA,AV GAONA 2068,-34.612851,-58.45664,6,0,6,006
COMUNA 6,73,INST MONSEÑOR DILLON,ALTE J F SEGUI 863,-34.615958,-58.455991,6,0,6,006
COMUNA 6,73,ESC Nº24 VIRGEN GENERALA,BIEDMA JOSE JUAN 459,-34.619174,-58.453019,3,0,3,006
COMUNA 6,73,ESC Nº25 REP DE GUATEMALA,MENDEZ DE ANDES 1451,-34.617644,-58.454511,5,0,5,006
COMUNA 6,73,INST ORSINO,LORENZO VINTTER 931,-34.613934,-58.455011,5,0,5,006
COMUNA 6,73,CLUB SOC Y DEP CABALLITO JUNIORS,NICASIO ORONO 566,-34.617612,-58.452407,7,0,7,006
COMUNA 6,73,CLUB SOC Y DEP UNION MARCHIGIANA,NICASIO ORONO 457,-34.618693,-58.4518,7,0,7,006
COMUNA 6,73,ESC Nº3 HIPOLITO VIEYTES,GAONA AV 1502,-34.609688,-58.45026,8,5,13,006
COMUNA 6,73,ESC Nº10 ARQ M J BUSCHIAZZO,F VALLESE 975,-34.614068,-58.448015,4,0,4,006
COMUNA 6,74,UBA FACULTAD DE FILOSOFIA Y LETRAS,PUAN 480,-34.628264,-58.446647,13,0,13,006
COMUNA 6,74,INST CULTURAL MARIANISTA,RIVADAVIA AV 5656,-34.62227,-58.445,10,0,10,006
COMUNA 6,74,INST ARGENTINO EXCELSIOR,RIVADAVIA AV 6028,-34.624322,-58.450405,9,0,9,006
COMUNA 6,74,ESC Nº3 M A MONTES DE OCA,PUAN 360,-34.626874,-58.447218,8,0,8,006
COMUNA 6,74,ESC Nº4 PTE DR ARTURO ILLIA,RIVADAVIA AV 6065,-34.624458,-58.451262,6,7,13,006
COMUNA 6,74,INST MONSEÑOR SABELLI,V MARTINEZ 62,-34.62343,-58.445152,3,0,3,006
COMUNA 6,74,INST GRAL JUSTO JOSE DE URQUIZA,V MARTINEZ 81,-34.623549,-58.445182,3,0,3,006
COMUNA 6,74,CLUB PORTUGUES,GOYENA PEDRO AV 1468,-34.627729,-58.447838,3,0,3,006
COMUNA 6,74,INST EDUCATIVO MODELO,ALBERDI JUAN BAUTISTA AV 1577,-34.626596,-58.450482,3,0,3,006
COMUNA 6,74,COLEGIO SAN CIRANO,VICTOR MARTINEZ 30,-34.622733,-58.445552,3,0,3,006
COMUNA 6,74,INST PROVOLO,ALBERDI JUAN BAUTISTA AV 1679,-34.627534,-58.452313,3,0,3,006
COMUNA 6,74,JARDIN DE INFANTES N°3 LA PORTEÑA,YERBAL 1548,-34.623454,-58.451838,5,0,5,006
COMUNA 7,75,ESC N°7 NIÑAS DE AYOHUMA,ASAMBLEA AV 1221,-34.635902,-58.442055,6,3,9,007
COMUNA 7,75,INST DE ED FISICA N°2 PROF F W DICKENS,CURAPALIGUE 1150,-34.635756,-58.446581,4,0,4,007
COMUNA 7,75,INST MEDALLA MILAGROSA,CURAPALIGUE 1155,-34.636159,-58.446338,11,0,11,007
COMUNA 7,75,CLUB GIMNASIO CHACABUCO,MIRO 750,-34.631939,-58.446103,9,0,9,007
COMUNA 7,76,CENTRO DE FORMACION PROFESIONAL N°6,ASAMBLEA AV 153,-34.631477,-58.427878,6,0,6,007
COMUNA 7,76,ESC N°22 ANTONIO ZINNY,SALAS 565,-34.632082,-58.434126,12,0,12,007
COMUNA 7,76,ESC N°17 PROF R BERNARDELLI,ESTRADA 627,-34.631558,-58.433869,9,4,13,007
COMUNA 7,76,ESC N°8 LUIS VERNET,HORTIGUERA 742,-34.631012,-58.443811,6,0,6,007
COMUNA 7,76,ESC N°1 CHACABUCO,PERON EVA AV 1502,-34.633106,-58.444896,14,0,14,007
COMUNA 7,77,ESC N°15 PCIA DE SALTA,SARAZA 1353,-34.638946,-58.436885,5,6,11,007
COMUNA 7,77,ESC N°24 DR FLORIAN OLIVER,SARAZA 470,-34.636998,-58.425363,4,0,4,007
COMUNA 7,77,ESC DE FORM EDUCATIVA Y DEPORTIVA,LA PLATA AV 1707,-34.635138,-58.424969,5,0,5,007
COMUNA 7,77,ESC N°23 CANADA,CACHIMAYO 1735,-34.639128,-58.435852,5,0,5,007
COMUNA 7,77,ESC SANTA COLOMA,SANTANDER 1150,-34.635542,-58.436168,5,0,5,007
COMUNA 7,77,ESC N°10 JUAN AGUSTIN MAZA,CACHIMAYO 1657,-34.638307,-58.436141,6,0,6,007
COMUNA 7,77,CLUB TELEGRAFO Y CRISOL UNIDOS,SARAZA 951,-34.637963,-58.431299,3,0,3,007
COMUNA 7,77,ESC N°21 JUAN JOSE PASO,BEAUCHEF 1869,-34.638714,-58.430509,5,0,5,007
COMUNA 7,78,INST SAN JUDAS TADEO,SOMELLERA 1720,-34.643879,-58.436018,11,0,11,007
COMUNA 7,78,ESC N°7 TTE MANUEL FELIX ORIGONE,PUMACAHUA 1247,-34.638449,-58.448007,9,0,9,007
COMUNA 7,78,ESC N°4 A TATIN RAVELLO,V MARTINEZ 1780,-34.640228,-58.43864,6,0,6,007
COMUNA 7,78,CLUB PEÑAROL,ZANARTU 1547,-34.640689,-58.439217,5,8,13,007
COMUNA 7,79,ESC N°5 REP DE SALVADOR,GRAL  ARTIGAS 878,-34.620797,-58.467861,6,0,6,007
COMUNA 7,79,INST MONSEÑOR ANEIROS DE SAN JOSE,F VALLESE 2549,-34.621684,-58.468199,7,0,7,007
COMUNA 7,79,ESC N°1 JULIO CORTAZAR,BOGOTA 2759,-34.626781,-58.469199,3,0,3,007
COMUNA 7,79,COLEGIO SCHONTHAL,AV NAZCA 537,-34.625836,-58.471703,17,0,17,007
COMUNA 7,79,ESC N°12 PCIA DEL CHACO,AVELLANEDA AV 2547,-34.624834,-58.466949,6,11,17,007
COMUNA 7,80,COLEGIO N°9 JUSTO JOSE DE URQUIZA,CONDARCO 290,-34.627914,-58.467866,20,0,20,007
COMUNA 7,80,ESC N°5 JUAN B PEÑA,M R TRELLES 948,-34.615511,-58.46018,8,5,13,007
COMUNA 7,80,ESC N°12 FACUNDO ZUVIRIA,FRANKLIN 1836,-34.615307,-58.460629,10,0,10,007
COMUNA 7,81,ESC N°15 CNEL C T SOURIGUES,ARANGUREN 2400,-34.62304,-58.464776,12,0,12,007
COMUNA 7,81,ESC PARA EL HOMBRE NUEVO,GRANADEROS 168,-34.62573,-58.459848,3,0,3,007
COMUNA 7,81,INST NTRA SRA DE LOURDES,RIVADAVIA AV 6270,-34.626072,-58.454945,12,0,12,007
COMUNA 7,81,CLUB ATLETICO INDEPENDIENTE,BOYACA AV 470,-34.621705,-58.460248,5,5,10,007
COMUNA 7,81,COLEGIO LA OBRA,CARACAS 325,-34.625647,-58.462377,4,0,4,007
COMUNA 7,82,INST ANA MARIA JANER,AV JUAN B ALBERDI 2555,-34.631855,-58.463868,10,0,10,007
COMUNA 7,82,ESC N°9 JOSE MARIA PAZ,CNEL R L FALCON 2934,-34.632399,-58.469615,5,5,10,007
COMUNA 7,82,ASOC ESPAÑOLA DE SOCORROS MUTUOS,PEDERNERA 143,-34.630963,-58.463447,10,3,13,007
COMUNA 7,82,JARDIN DE INFANTES N°1,SAN PEDRITO 341,-34.634931,-58.467867,3,0,3,007
COMUNA 7,82,ESC N°8 CNEL ING PEDRO CERVIÑO,VARELA AV 358,-34.633836,-58.463623,8,0,8,007
COMUNA 7,82,COLEGIO DEL LIBERTADOR,DIRECTORIO AV 2959,-34.635715,-58.468468,6,0,6,007
COMUNA 7,83,INST SAN JOSE DE FLORES,JOSE BONIFACIO 2475,-34.63264,-58.462174,4,0,4,007
COMUNA 7,83,ESC N°15 REP ORIENTAL DEL URUGUAY,CARABOBO AV 253,-34.629895,-58.455277,10,7,17,007
COMUNA 7,83,LICEO N°5 PASCUAL GUAGLIANONE,AV CARABOBO 286,-34.630162,-58.454928,5,0,5,007
COMUNA 7,83,ESC N°19 LEANDRO N ALEM,FRAY CAYETANO RODRIGUEZ 95,-34.627766,-58.463068,17,0,17,007
COMUNA 7,83,ESC N°5 R DE ESCALADA DE SAN MARTIN,ALBERDI JUAN BAUTISTA AV 1845,-34.62896,-58.454692,5,0,5,007
COMUNA 7,83,ESC N°9 JOSE INGENIEROS,CNEL R L FALCON 2248,-34.629426,-58.459913,8,0,8,007
COMUNA 7,83,INST SARA CHAMBERLAIN DE ECCLESTON,CARABOBO AV 58,-34.627407,-58.456254,4,0,4,007
COMUNA 7,83,ESC N°21 CAP HIPOLITO BOUCHARD,PUMACAHUA 390,-34.630874,-58.453311,6,0,6,007
COMUNA 7,84,ESC N°6 DR CARLOS VAZ FERREIRA,VARELA AV 1040,-34.64064,-58.45725,6,0,6,007
COMUNA 7,84,ESC N° 16 SANTA CRUZ Y ESPEJO,PRIMERA JUNTA 3445,-34.643963,-58.465132,3,0,3,007
COMUNA 7,84,ESC N°12 RECONQUISTA,VARELA AV 753,-34.638268,-58.460024,4,0,4,007
COMUNA 7,84,ESC N°10 ING OCTAVIO S PICO,LAFUENTE 559,-34.636956,-58.465497,3,5,8,007
COMUNA 7,84,ESC N° 5 A G DE RYAN,PORTELA 734,-34.640415,-58.46962,4,0,4,007
COMUNA 7,84,I C D CLUB PEDRO ECHAGÜE,PORTELA 836,-34.641855,-58.468613,8,0,8,007
COMUNA 7,84,FLORES CLUB,QUIRNO 947,-34.642569,-58.464205,4,0,4,007
COMUNA 7,85,INST NTRA SRA DE LUJAN 2,CARABOBO AV 967,-34.637123,-58.451718,3,0,3,007
COMUNA 7,85,INST G DE HONOR DEL SANTISIMO ROSARIO,LAUTARO 824,-34.636088,-58.453426,8,0,8,007
COMUNA 7,85,ESC N°24 DR PEDRO A TORRES,LAUTARO 752,-34.635337,-58.453783,3,0,3,007
COMUNA 7,85,INST NTRA SRA DE LA MISERICORDIA,CAMACUA 493,-34.63315,-58.456087,5,2,7,007
COMUNA 7,85,INST VIRGINIO F GRIEGO,DIRECTORIO AV 2220,-34.632751,-58.458038,4,0,4,007
COMUNA 7,86,ESC N°4 BENJAMIN ZORRILLA,AV SAN PEDRITO 1415,-34.645871,-58.457526,7,14,21,007
COMUNA 7,86,ESC N°23 GRAL SAVIO,SAN PEDRITO 1137,-34.643367,-58.460281,8,0,8,007
COMUNA 7,86,COLEGIO ARMENIO ARZRUNI,J MARTI 1580,-34.647132,-58.46009,5,0,5,007
COMUNA 7,86,INST SANTA CLARA,ZUVIRIA 2660,-34.642923,-58.455874,5,8,13,007
COMUNA 7,86,ESC N°22 HIPOLITO BOUCHARD,AVELINO DIAZ 2356,-34.64313,-58.450062,4,11,15,007
COMUNA 7,86,ESC N°3 PROF CARLOS GENISO,A DE VEDIA 2519,-34.648197,-58.43262,6,6,12,007
COMUNA 7,86,ESC N°13 FRANCISCO JACQUES,LAUTARO 1440,-34.641665,-58.44767,4,9,13,007
COMUNA 7,86,CLUB DAOM,VARELA AV 1802,-34.647257,-58.449207,8,5,13,007
COMUNA 7,86,CLUB SAN LORENZO DE ALMAGRO,FERNANDEZ DE LA CRUZ AV 2145,-34.654438,-58.436476,22,17,39,007
COMUNA 7,86,ESC N°4 RICARDO GÜIRALDES,RIESTRA AV 1850,-34.646508,-58.435541,3,6,9,007
COMUNA 7,86,COLEGIO ARMENIO ARZRUNI - GIMNASIO,J MARTI 1561,-34.646999,-58.460399,9,0,9,007
COMUNA 7,86,INST ELISA HARILAOS,SAN PEDRITO 1347,-34.645364,-58.458076,8,0,8,007
COMUNA 8,87,ESC N° 9 DR JOSE BENJAMIN ZUBIAUR,CARLOS BERG 3460,-34.6608,-58.428149,4,0,4,008
COMUNA 8,87,ESC N° 14 C MARIA REMEDIOS DEL VALLE,RABANAL FRANCISCO INT AV 2751,-34.662063,-58.43437,5,0,5,008
COMUNA 8,87,ESC N° 8 DR LUIS FEDERICO LELOIR,RABANAL FRANCISCO INT AV 2275,-34.659592,-58.428936,5,0,5,008
COMUNA 8,87,INST SAN JOSE,CORRALES 3188,-34.663212,-58.440937,6,0,6,008
COMUNA 8,87,ESC N° 17 GASPAR LUCILO BENAVENTO,CORRALES 3420,-34.665254,-58.443403,8,0,8,008
COMUNA 8,87,ESC N° 18 SAN JUAN B DE LA SALLE,CORRALES 3450,-34.665505,-58.443916,3,12,15,008
COMUNA 8,87,INST CRISTO OBRERO,LAFUENTE 3202,-34.66285,-58.438571,5,0,5,008
COMUNA 8,87,ESC N° 15 EVARISTO CARRIEGO,PORTELA 3150,-34.662154,-58.442977,6,0,6,008
COMUNA 8,87,INST NTRA SRA DE FATIMA,PORTELA 2750,-34.65705,-58.449427,9,6,15,008
COMUNA 8,87,ESC N°5 DE REINGRESO,FERNANDEZ DE LA CRUZ  AV 3605,-34.664293,-58.448936,5,0,5,008
COMUNA 8,87,ESC N°20 MAESTRO C A CARRANZA,MARTINEZ CASTRO 3061,-34.662247,-58.448753,7,0,7,008
COMUNA 8,87,ESC N°19 DR ARTURO JAURETCHE,MARTINEZ CASTRO 3067,-34.662284,-58.448705,4,12,16,008
COMUNA 8,87,ESC N°21 MAESTRO GUILLERMO BARROS,M ACOSTA 2976,-34.660259,-58.448855,6,0,6,008
COMUNA 8,87,PARQUE ROCA - PABELLON EUROPA,ROCA CNEL AV 4200,-34.675488,-58.447466,15,0,15,008
COMUNA 8,87,PARQUE ROCA - PABELLON AFRICA,ROCA CNEL AV 4200,-34.675488,-58.447466,0,14,14,008
COMUNA 8,87,INST ISAAC BAKCHELLIAN,CORRALES 2527,-34.657952,-58.434789,3,0,3,008
COMUNA 8,87,INST CRISTO OBRERO - GIMNASIO,CONDOR 2947,-34.662873,-58.437291,6,0,6,008
COMUNA 8,88,ESC N° 13 DR ALFREDO LANARI,AV PIEDRA BUENA 4863,-34.687249,-58.475828,6,0,6,008
COMUNA 8,88,ESC N° 16 DR SOFANOR N CORVALAN,BERON DE ASTRADA 6351,-34.691903,-58.467041,5,0,5,008
COMUNA 8,88,COLEGIO MACNAB BERNAL - SECUNDARIA,ITAQUI 6800,-34.690509,-58.476293,4,0,4,008
COMUNA 8,88,COLEGIO MACNAB BERNAL - PRIMARIA,FERNANDEZ DE LA CRUZ AV 6880,-34.690156,-58.478048,8,0,8,008
COMUNA 8,88,INST SAGRADA FAMILIA,COSQUIN 4951,-34.687462,-58.473877,7,0,7,008
COMUNA 8,88,ESC N°18 JORGE NEWBERY,ROCA CNEL AV 5898,-34.690284,-58.461506,7,5,12,008
COMUNA 8,88,CLUB EL IDEAL,MONTIEL 5142,-34.688441,-58.477458,9,0,9,008
COMUNA 8,89,ESC N° 13 ING JOSE LUIS DELPINI,CNEL M CHILAVERT 5460,-34.679073,-58.467432,14,0,14,008
COMUNA 8,89,ESC N° 3 CRISTOBAL COLON,LARRAZABAL 4051,-34.676468,-58.472146,8,0,8,008
COMUNA 8,89,ESC N° 4 PROV DE TUCUMAN,RIESTRA AV 5030,-34.671805,-58.469381,7,10,17,008
COMUNA 8,89,INST PARROQUIAL MARIO F ALSINA,M LEGUIZAMON 4030,-34.676553,-58.477846,7,0,7,008
COMUNA 8,89,ESC N° 15 DR CARLOS ALBERTO VERONELLI,CAFAYATE 5388,-34.688868,-58.46324,9,10,19,008
COMUNA 8,89,ESC DE BELLAS ARTES LOLA MORA,SOLDADO DE LA FRONTERA AV 5155,-34.685081,-58.464351,8,0,8,008
COMUNA 8,89,ESC N° 10 ITALO AMERICO FORADORI,LARRAZABAL 5001,-34.681727,-58.464043,8,10,18,008
COMUNA 8,89,ESC N° 5 ARMADA ARGENTINA,LARRAZABAL 4520,-34.680182,-58.465966,6,10,16,008
COMUNA 8,89,ESC N° 1 CONCEJAL ALBERTO SALVATORI,CAFAYATE 5115,-34.68661,-58.466406,12,10,22,008
COMUNA 8,89,ESC N° 9 HECTOR PANIZZA,BERON DE ASTRADA 5920,-34.688302,-58.463126,7,10,17,008
COMUNA 8,89,ESC N° 6 REP DE LA INDIA,N DESCALZI 5425,-34.682425,-58.46375,8,0,8,008
COMUNA 8,89,ESC N°35 LEOPOLDO MARECHAL,LARRAZABAL 5140,-34.683915,-58.46074,11,0,11,008
COMUNA 8,89,ESC N°2 MAESTRO LUIS VICENTE,LARRAZABAL 5440,-34.686194,-58.457607,8,0,8,008
COMUNA 8,89,ESC N°14 DR RICARDO LEVENE,CANADA DE GOMEZ 4548,-34.683024,-58.477935,10,9,19,008
COMUNA 8,89,CLUB SOC Y DEP YUPANQUI,GUAMINI 4502,-34.683913,-58.481771,12,0,12,008
COMUNA 8,89,UBA - CBC SEDE LUGANO,CAMINO PARQUE VICTORIA 5347,-34.67901,-58.464665,5,0,5,008
COMUNA 8,90,JARDIN DE INFANTES N°3,AV PIEDRA BUENA 3100,-34.671557,-58.496206,7,0,7,008
COMUNA 8,90,JARDIN DE INFANTES INTEGRAL N°1 3,ZUVIRIA 6680,-34.676019,-58.493666,9,0,9,008
COMUNA 8,90,UTN CAMPUS UNIVERSITARIO,MOZART 2300,-34.659415,-58.469109,10,18,28,008
COMUNA 8,90,ESC N° 15 REP ARGENTINA,CASTANARES AV 4689,-34.665757,-58.471555,3,10,13,008
COMUNA 8,90,ESC N° 21 SOLDADO DE MALVINAS,GTA SANTA CRUZ 6999,-34.679708,-58.493677,8,0,8,008
COMUNA 8,90,ESC N° 20 DRA A MOREAU DE JUSTO,GTA SANTA CRUZ 6997,-34.679708,-58.493677,4,0,4,008
COMUNA 8,90,INST NTRA SRA DE LA PAZ,PIEDRA BUENA AV 3595,-34.675272,-58.490721,8,0,8,008
COMUNA 8,90,ESC N° 11 PONCIANO VIVANCO,OLIDEN 2851,-34.66488,-58.489528,6,0,6,008
COMUNA 8,90,ESC N° 12 JUAN XXIII,AQUINO 6040,-34.677457,-58.480374,9,0,9,008
COMUNA 8,90,ESC N° 9 HOMERO MANZI,MIRALLA 2666,-34.662837,-58.482075,8,0,8,008
COMUNA 8,90,INST DON ORIONE 2,PIEDRA BUENA AV 3848,-34.678214,-58.487356,7,0,7,008
COMUNA 8,90,ESC N° 8 JUDITH Y DEMETRIO DEMARCHI,JOSE I RUCCI 3961,-34.676521,-58.4806,5,6,11,008
COMUNA 8,90,ESC N° 22 STA MARIA DE LOS BS AS,ECHEANDIA 5650,-34.666727,-58.485717,8,0,8,008
COMUNA 8,90,ESC N° 6 AMERICA,ESCALADA AV 2890,-34.664389,-58.470464,13,0,13,008
COMUNA 8,90,CLUB SOC Y DEP PAMPERO,LARRAZABAL 3033,-34.667497,-58.483696,3,0,3,008
COMUNA 8,90,CLUB LUGANO TENIS,ZELARRAYAN 5740,-34.674347,-58.479789,9,0,9,008
COMUNA 8,90,MIN DE DESARROLLO HUMANO Y HABITAT,PIEDRA BUENA AV 3280,-34.672043,-58.493718,9,0,9,008
COMUNA 8,90,ESC N°2 PAMPERO,CANADA DE GOMEZ 3850,-34.676087,-58.48652,6,0,6,008
COMUNA 8,90,ESC N°24,ZUVIRIA 6590,-34.675013,-58.492553,7,0,7,008
COMUNA 9,91,ESC N°5 ROBERTO BILLINGHURST,ZINNY 1641,-34.652186,-58.471545,7,0,7,009
COMUNA 9,91,ASOC DE FOMENTO MARIANO ACOSTA,M ACOSTA 1544,-34.647303,-58.465375,7,6,13,009
COMUNA 9,91,ESC N°20 ANTONIO ALICE,FERNANDEZ MORENO 3652,-34.645156,-58.469321,3,8,11,009
COMUNA 9,91,INST PARROQUIAL MADRE DE DIOS,SARAVIA 2335,-34.659037,-58.476061,3,0,3,009
COMUNA 9,91,ESC N°8 REINO DE THAILANDIA,HOMERO 2159,-34.65867,-58.475211,10,2,12,009
COMUNA 9,92,CLUB SOC Y DEP AMERICA DEL SUD,FCO BILBAO 3760,-34.644112,-58.473221,10,0,10,009
COMUNA 9,92,ESC N°11 DR PEDRO GOYENA,G DE LAFERRERE 3624,-34.643233,-58.469207,9,0,9,009
COMUNA 9,92,ESC N°17 BRIG GRAL C SAAVEDRA,LACARRA AV 535,-34.640065,-58.481578,10,5,15,009
COMUNA 9,92,INST LUJAN PORTEÑO,FCO BILBAO 3476,-34.641862,-58.469913,4,0,4,009
COMUNA 9,92,ESC N°17 JUAN GALO LAVALLE,EUGENIO GARZON 3950,-34.643026,-58.476456,6,5,11,009
COMUNA 9,93,ESC N°16 TOMAS LE BRETON,EUGENIO GARZON 4346,-34.648098,-58.481711,7,0,7,009
COMUNA 9,93,INST NTRA SRA DE LOS REMEDIOS,FCO BILBAO 4310,-34.649963,-58.479349,9,0,9,009
COMUNA 9,93,ESC N°10 ANTONIO ZACCAGNINI,LACARRA AV 1135,-34.644637,-58.47571,8,4,12,009
COMUNA 9,94,ALVEAR CLUB,J E RODO 4190,-34.641955,-58.482928,7,0,7,009
COMUNA 9,94,ALVEAR CLUB ANEXO,AV DIRECTORIO 4147,-34.643361,-58.482446,9,0,9,009
COMUNA 9,94,ESC N°8 P ALBARRACIN DE SARMIENTO,PIO COLLIVADINO 436,-34.640491,-58.483547,4,4,8,009
COMUNA 9,94,ESC N°24 SARA DE ELIA DE GIMENEZ,BRUIX AV 4620,-34.646212,-58.490274,3,0,3,009
COMUNA 9,94,ESC N°20 SARGENTO JUAN B CABRAL,HOMERO 1157,-34.648893,-58.487605,5,0,5,009
COMUNA 9,94,ESC N°21 PEDRO INCHAUSPE,J E RODO 4431,-34.643834,-58.486786,3,0,3,009
COMUNA 9,95,ASOC VECINAL JOSE HERNANDEZ,BRAGADO 5950,-34.653441,-58.502739,5,9,14,009
COMUNA 9,95,ASOC DE FOMENTO CORVALAN,TAPALQUE 5147,-34.64862,-58.494668,6,0,6,009
COMUNA 9,95,INST SAN PIO X,ARTIGAS MANUEL DE 5261,-34.645121,-58.497729,5,0,5,009
COMUNA 9,95,ESC N°4 REP DEL BRASIL,ARTIGAS MANUEL DE 5951,-34.649923,-58.502924,4,0,4,009
COMUNA 9,95,INST CALASANCIO DIVINA PASTORA,ARTIGAS MANUEL DE 6124,-34.651458,-58.504447,3,0,3,009
COMUNA 9,95,LICEO N°8 ESTEBAN ECHEVERRIA,MURGUIONDO 1568,-34.653213,-58.505185,4,0,4,009
COMUNA 9,95,ESC N°13 PROF LUZ VIEIRA MENDEZ,BRAGADO 5350,-34.649045,-58.497465,5,0,5,009
COMUNA 9,95,ESC N°2 PATRIA GRANDE,CHASCOMUS 5598,-34.653919,-58.496567,6,0,6,009
COMUNA 9,95,ESC N°3 E DR EDUARDO L HOLMBERG,AV LARRAZABAL 1556,-34.653763,-58.499487,3,0,3,009
COMUNA 9,95,INST PLACIDO MARIN,AV LARRAZABAL 1551,-34.653807,-58.499598,5,0,5,009
COMUNA 9,95,INST SAN VICENTE DE PAUL 4,OLIDEN 1440,-34.652329,-58.504852,4,0,4,009
COMUNA 9,96,CLUB BRISAS DEL SUD,GUARDIA NACIONAL 1956,-34.654987,-58.483939,3,0,3,009
COMUNA 9,96,ESC N°12 PRESBITERO MONTES CARBALLO,LARRAYA 2055,-34.657598,-58.493872,7,4,11,009
COMUNA 9,96,ESC N°14 JOSE ANTONIO CABRERA,SAN PEDRO 5845,-34.659221,-58.492627,6,0,6,009
COMUNA 9,96,CLUB SOCIAL Y DEPORTIVO ARGENTINO,ALBARINO 2253,-34.658694,-58.485886,12,5,17,009
COMUNA 9,96,ESC N° 19 CAJA NAC DE AHORRO Y SEGURO,ALBARINO 2062,-34.656792,-58.488197,6,2,8,009
COMUNA 9,97,ESC N°6 PROF FELIPE BOERO - ADULTOS,PERON EVA AV 7431,-34.673519,-58.500957,7,0,7,009
COMUNA 9,97,ESC N°14 ISLAS MALVINAS,DE LOS CORRALES AV 7040,-34.666235,-58.504402,3,0,3,009
COMUNA 9,97,ESC N°11 EMILIO VON BEHRING,CARDENAS CORONEL AV 2652,-34.666585,-58.502278,5,0,5,009
COMUNA 9,97,ESC N°6 FELIPE BOERO,PERON EVA AV 7449,-34.673635,-58.501172,3,0,3,009
COMUNA 9,97,ESC N°20 POLO ED MATADEROS - SECUNDARIA,P DE LOS ARTISTAS Y AV DIRECTORIO,-34.658883,-58.500632,5,0,5,009
COMUNA 9,97,ESC N°23 POLO ED MATADEROS - PRIMARIA,P DE LOS ARTISTAS Y REMEDIOS,-34.661677,-58.498003,5,5,10,009
COMUNA 9,97,ESC N°19 ROMA,COSQUIN 3100,-34.66884,-58.498042,6,0,6,009
COMUNA 9,98,CLUB SOC Y DEP GRAL LAMADRID,CARHUE 2049,-34.659641,-58.511631,9,0,9,009
COMUNA 9,98,INST SAN FELIPE NERI,ANDALGALA 2264,-34.662125,-58.506932,5,0,5,009
COMUNA 9,98,ESC N°16 DR MARTINIANO LEGUIZAMON,M LEGUIZAMON 1470,-34.652398,-58.508513,7,0,7,009
COMUNA 9,98,INST ANA MARIA MOGAS - GIMNASIO,CARHUE 1855,-34.657809,-58.51397,11,0,11,009
COMUNA 9,98,INST NTRA SRA DE LUJAN DE LOS PATRIOTAS,ERCILLA 7195,-34.654194,-58.517883,11,0,11,009
COMUNA 9,98,ESC N° 13 REP DE FILIPINAS,COSQUIN 1943,-34.658434,-58.509922,5,0,5,009
COMUNA 9,98,CLUB GLORIAS ARGENTINAS,BRAGADO 6875,-34.659277,-58.509886,10,6,16,009
COMUNA 9,98,ESC N°7 ARISTOBULO DEL VALLE,CARHUE 2157,-34.660727,-58.51033,4,0,4,009
COMUNA 9,99,CLUB BRISAS DE LINIERS,MONTIEL 1382,-34.65387,-58.52228,5,2,7,009
COMUNA 9,99,CLUB ATLETICO JUVENTUD DE LINIERS,MONTIEL 1174,-34.652003,-58.52475,3,0,3,009
COMUNA 9,99,ASOC CIVIL MERLOT,CAFAYATE 758,-34.647067,-58.517356,5,0,5,009
COMUNA 9,99,INST SAN JOSE SECUNDARIO,MURGUIONDO 1029,-34.649226,-58.511371,5,0,5,009
COMUNA 9,99,ESC N°1 DE LA INDEPENDENCIA ARGENTINA,GUAMINI 1167,-34.652159,-58.523009,5,0,5,009
COMUNA 9,99,ESC N°10 ALFONSINA STORNI,L DE LA TORRE 1171,-34.650993,-58.515192,4,0,4,009
COMUNA 9,99,INST SAN JOSE PRIMARIO,AV EMILIO CASTRO 6351,-34.650039,-58.511423,5,0,5,009
COMUNA 9,100,CLUB LARRAZABAL,LARRAZABAL 829,-34.647225,-58.50741,3,0,3,009
COMUNA 9,100,CLUB SOC Y DEP GRAL SAN MARTIN,OLIDEN 956,-34.648142,-58.509913,6,4,10,009
COMUNA 9,100,ASOC DE FOMENTO SANTIAGO DE LINIERS,CAAGUAZU 6151,-34.643567,-58.51483,8,0,8,009
COMUNA 9,100,ESC N°8 DR D VELEZ SARSFIELD,FONROUGE 370,-34.642293,-58.512299,6,0,6,009
COMUNA 9,100,ESC N°32 JOSE L SUAREZ,ACASSUSO 5860,-34.644045,-58.508672,3,0,3,009
COMUNA 9,100,ESC N°18 REP DE COREA,MURGUIONDO 76,-34.640028,-58.518622,5,0,5,009
COMUNA 9,100,ESC N°9 JOSE MARIA TORRES,LARRAZABAL 420,-34.643408,-58.511972,3,0,3,009
COMUNA 9,100,ESC DE DANZA N°1 PROF NELLY RAMICONE,FONROUGE 711,-34.645765,-58.507361,7,0,7,009
COMUNA 9,101,CLUB VELEZ SARSFIELD,JUSTO JUAN B AV 9200,-34.633653,-58.519508,6,0,6,009
COMUNA 9,101,ESC N°15 REP ISLAMICA DE PAKISTAN,L DE LA TORRE 550,-34.64504,-58.520399,5,0,5,009
COMUNA 9,101,INST NTRA SRA DE LAS NIEVES,VENTURA BOSCH 6651,-34.642527,-58.520002,4,0,4,009
COMUNA 9,101,ESC N°2 FCO MELITON ALVAREZ,MONTIEL 1041,-34.650684,-58.525719,4,0,4,009
COMUNA 9,101,ESC N°22 PCIA DE SANTA CRUZ,CUZCO 116,-34.637672,-58.527965,4,0,4,009
COMUNA 9,101,ESC N°20 M SANCHEZ DE LORIA,BARRAGAN 366,-34.636352,-58.52287,4,0,4,009
COMUNA 9,101,ESC N°4 GRAL FELIX DE OLAZABAL,CNEL R L FALCON 6702,-34.640309,-58.521277,5,0,5,009
COMUNA 9,101,ESC N°17 CARLOS MOREL,IBARROLA 7249,-34.641667,-58.528141,4,0,4,009
COMUNA 9,101,INST DR D VELEZ SARSFIELD,RESERVISTAS ARGENTINOS AV 249,-34.636124,-58.521793,4,10,14,009
COMUNA 9,101,ESC N°3 REP FRANCESA,MONTIEL 153,-34.640985,-58.526345,3,0,3,009
COMUNA 9,101,COLEGIO ARGENTINO B FERNANDEZ MORENO,L DE LA TORRE 278,-34.642338,-58.520794,3,0,3,009
COMUNA 9,101,INST SAN CAYETANO,CUZCO 176,-34.637508,-58.527984,4,0,4,009
COMUNA 10,102,LA FABRICA DEPORTIVA,ROMA 560,-34.631316,-58.520736,8,0,8,010
COMUNA 10,102,ESC N° 16 J F KENNEDY,BRUSELAS 721,-34.6293,-58.522594,5,3,8,010
COMUNA 10,102,ESC N° 25 ESTADOS UNIDOS,BRUSELAS 785,-34.628456,-58.522807,5,0,5,010
COMUNA 10,102,INST NTRA SRA DEL BUEN Y PERPETUO SOCORRO,IRIGOYEN 1143,-34.629751,-58.514605,10,0,10,010
COMUNA 10,102,ESC N° 24 MAIPU,GALLARDO 521,-34.632699,-58.524601,6,0,6,010
COMUNA 10,102,ESC N°14 GUILLERMO HUDSON,ARREGUI 6840,-34.629366,-58.528451,4,0,4,010
COMUNA 10,103,ESC N°14 SIMON BOLIVAR,TINOGASTA 5768,-34.620997,-58.525366,4,0,4,010
COMUNA 10,103,ESC CRISTIANA EVANGELICA ARGENTINA,IRIGOYEN 2150,-34.621719,-58.525208,8,3,11,010
COMUNA 10,103,ESC N° 13 PREFECTURA NAVAL ARGENTINA,SIMBRON 5821,-34.620693,-58.526832,5,0,5,010
COMUNA 10,103,ESC N°2 RUMANIA,PORCEL DE PERALTA MANUEL 1437,-34.621793,-58.529036,6,0,6,010
COMUNA 10,103,JARDIN DE INFANTES N°5,CNEL RAMON LISTA 5448,-34.615922,-58.525696,3,0,3,010
COMUNA 10,103,ESC INTEGRAL INTERDISCIPLINARIA N°17,CNEL RAMON LISTA 5450,-34.61593,-58.525705,3,0,3,010
COMUNA 10,103,CLUB JORGE NEWBERY,IRIGOYEN 2092,-34.622234,-58.524541,7,0,7,010
COMUNA 10,104,ESC N°1 MARTIN FIERRO,MARTIN FIERRO 5351,-34.623456,-58.513808,5,0,5,010
COMUNA 10,104,ESC N°35 INGENIERO E LATZINA,LOPE DE VEGA AV 2150,-34.620607,-58.51653,5,0,5,010
COMUNA 10,104,ESC N°27 HIPOLITO YRIGOYEN,VIRGILIO 1980,-34.621466,-58.517457,7,3,10,010
COMUNA 10,104,ESC N°33 MAIPU,ALVAREZ JONTE AV 5075,-34.621342,-58.508374,5,0,5,010
COMUNA 10,104,ESC N°18 GENDARMERIA NACIONAL,JUAN A GARCIA 5265,-34.627087,-58.506802,5,0,5,010
COMUNA 10,104,ESC CRISTIANA DE LA PUERTA ABIERTA - SECUNDARIA,CERVANTES 2282,-34.619011,-58.512895,3,0,3,010
COMUNA 10,104,ESCUELA CRISTIANA DE LA PUERTA ABIERTA - PRIMARIA,SANTO TOME 5130,-34.619947,-58.512579,6,0,6,010
COMUNA 10,105,ESC N°9 PCIA DE MISIONES,LASCANO 4044,-34.61436,-58.498365,7,0,7,010
COMUNA 10,105,ESC Nº29 DR OSVALDO MAGNASCO,CHIVILCOY 1820,-34.617075,-58.496176,8,5,13,010
COMUNA 10,105,ESC N° 3 MONTE CASTRO,ALVAREZ JONTE AV 4651,-34.618846,-58.504099,7,0,7,010
COMUNA 10,105,ESC N° 17 TTE GRAL L M CAMPOS,SANTO TOME 4529,-34.615415,-58.50558,7,0,7,010
COMUNA 10,105,ESC N° 2 ALEJANDRO AGUADO,CERVANTES 1911,-34.621745,-58.509245,10,0,10,010
COMUNA 10,105,INST SAN RAFAEL,BENITO JUAREZ 2159,-34.619658,-58.504479,5,0,5,010
COMUNA 10,105,COLEGIO NUEVOS AIRES,BAHIA BLANCA 2246,-34.61341,-58.498326,7,0,7,010
COMUNA 10,105,ESC N° 24 ROBERTO M ORTIZ,BAHIA BLANCA 2535,-34.610332,-58.50099,3,0,3,010
COMUNA 10,106,ESC N° 30 DR ESTEBAN GASCON,SAN BLAS 5387,-34.630594,-58.508889,7,3,10,010
COMUNA 10,106,INST SACRATISIMO CORAZON DE JESUS,MOLIERE 856,-34.63105,-58.506765,6,0,6,010
COMUNA 10,106,CLUB VILLA LURO NORTE,ELPIDIO GONZALEZ 5445,-34.628789,-58.510598,10,0,10,010
COMUNA 10,106,CLUB STENTOR,PJE CAMOATI Y VICTOR HUGO,-34.634563,-58.504651,10,0,10,010
COMUNA 10,107,ASOC LOS AMIGOS DE VILLA LURO,CNEL R L FALCON 5176,-34.638864,-58.500226,10,0,10,010
COMUNA 10,107,ESC N° 7 REP ARABE DE EGIPTO,RIVADAVIA AV 9799,-34.637674,-58.501875,7,0,7,010
COMUNA 10,107,ESC N° 1 PROF JOSE ONAINDIA,RAFAELA 5159,-34.640015,-58.499813,7,0,7,010
COMUNA 10,107,ESC N°7 RECUERDOS DE PROVINCIA,ALBERDI JUAN BAUTISTA AV 4755,-34.643653,-58.492945,7,0,7,010
COMUNA 10,107,ESC N°6 CARLOS GUIDO Y SPANO,CNEL R L FALCON 4801,-34.638138,-58.495205,6,0,6,010
COMUNA 10,107,ESC N° 12 PROF RAMON GENE,G DE COSSIO 5570,-34.640263,-58.508869,5,0,5,010
COMUNA 10,107,ESC MODELO D F SARMIENTO,RIVADAVIA AV 9441,-34.637015,-58.497161,5,0,5,010
COMUNA 10,107,ESC N° 8 BASE AEREA V C MARAMBIO,YERBAL 4965,-34.636027,-58.496157,8,6,14,010
COMUNA 10,108,ESC N° 10 ADA MARIA ELFLEIN,DR L BELAUSTEGUI 4949,-34.631075,-58.498971,4,0,4,010
COMUNA 10,108,INST SAN RAMON NONATO,CERVANTES 1168,-34.627834,-58.501448,5,0,5,010
COMUNA 10,108,ESC N°4 CASIMIRO A MACIEL,MARCOS PAZ 1732,-34.623656,-58.50132,6,0,6,010
COMUNA 10,108,INST CRISTO REY,E LARROQUE DE R 4736,-34.629393,-58.495742,4,0,4,010
COMUNA 10,108,ESC N°15 MANUEL PEÑA,SEGUROLA AV 1104,-34.625584,-58.492967,5,0,5,010
COMUNA 10,108,ASOCIACION GIOVANNI GENTILE,JUAN A GARCIA 5270,-34.627209,-58.506808,4,0,4,010
COMUNA 10,108,CLUB CANBA,SAN BLAS 4577,-34.623187,-58.499332,6,3,9,010
COMUNA 10,109,INST JUAN BAUTISTA BERTHIER,BACACAY 4723,-34.634211,-58.493175,5,2,7,010
COMUNA 10,109,INST SANTISIMO SACRAMENTO,BACACAY 4890,-34.63458,-58.495334,6,2,8,010
COMUNA 10,109,ESC N° 1 JOSE A FERREIRA,CNEL R L FALCON 4126,-34.635966,-58.484778,7,0,7,010
COMUNA 10,109,ESC N° 2 MAXIMIO SABA VICTORIA,CNEL R L FALCON 4151,-34.63604,-58.485431,7,0,7,010
COMUNA 10,109,INST NTRA SRA DEL MILAGRO,RAFAELA 3865,-34.636389,-58.480445,4,0,4,010
COMUNA 10,109,ESC N°3 ANGELA M DE CAVIGLIA,M ACOSTA 45,-34.63453,-58.481731,5,0,5,010
COMUNA 10,109,SEMINARIO INT TEOLOGICO BAUTISTA - SUM,BOLANOS 150,-34.636423,-58.484099,8,4,12,010
COMUNA 10,109,SEMINARIO INT TEOLOGICO BAUTISTA,CNEL R L FALCON 4080,-34.635759,-58.483891,4,0,4,010
COMUNA 10,109,INST ESPIRITU SANTO,G DE FONSECA 309,-34.632201,-58.48966,4,0,4,010
COMUNA 10,109,ESC DE ARTE ROGELIO YRURTIA,CAJARAVILLA 4158,-34.638475,-58.48461,4,0,4,010
COMUNA 10,110,ESC N° 10 CNEL DE MARINA L ROSALES,MERCEDES 1405,-34.621553,-58.492288,6,0,6,010
COMUNA 10,110,ESC N° 16 ERNESTO A BAVIO,BAHIA BLANCA 1551,-34.619694,-58.49091,5,0,5,010
COMUNA 10,110,ESC N° 11 REP DE PERU,GAONA AV 4763,-34.627391,-58.489699,4,3,7,010
COMUNA 10,110,ESC N° 13 CNEL J A MELIAN,CAMARONES 4351,-34.622645,-58.495588,6,0,6,010
COMUNA 10,110,ESC N° 11 ANDRES BELLO,DR L BELAUSTEGUI 3751,-34.622273,-58.486708,4,0,4,010
COMUNA 10,110,ESC N°19 DR PEDRO I RIVERA,SAN BLAS 4356,-34.621837,-58.496586,4,0,4,010
COMUNA 10,111,ESC N° 24 PADRE CASTAÑEDA,MORON 3745,-34.626768,-58.482636,8,7,15,010
COMUNA 10,111,COLEGIO N°18 DR A LARROQUE,MORON 4149,-34.628045,-58.487876,8,10,18,010
COMUNA 10,111,ESC N° 23 REP DE PORTUGAL,GUALEGUAYCHU 550,-34.629423,-58.486548,7,0,7,010
COMUNA 10,111,INSTITUTO LA CANDELARIA - SECUNDARIA,BAHIA BLANCA 363,-34.629723,-58.482001,6,0,6,010
COMUNA 10,111,INSTITUTO LA CANDELARIA - PRIMARIA,J F ARANGUREN 4015,-34.628643,-58.485795,4,0,4,010
COMUNA 10,112,ESC N° 9 M FERNANDEZ,BACACAY 3542,-34.630417,-58.478102,8,0,8,010
COMUNA 10,112,ESC N° 3 E GIMENEZ ZAPIOLA,JOAQUIN V GONZALEZ 180,-34.631079,-58.479902,5,6,11,010
COMUNA 10,112,COLEGIO NTRA SRA DE LA PAZ,PERGAMINO 53,-34.632924,-58.474263,5,0,5,010
COMUNA 10,112,ESC N° 19 FRAGATA ARA LIBERTAD,BONIFACIO JOSE 3650,-34.637357,-58.476438,6,0,6,010
COMUNA 11,113,INST SANTA RITA,PAULA A DE SARMIENTO 3436,-34.615359,-58.487478,8,5,13,011
COMUNA 11,113,ESC N° 18 PCIA DE TIERRA DEL FUEGO,JULIO S DANTAS 3260,-34.610946,-58.488196,7,0,7,011
COMUNA 11,113,ESC N°16 DRA CAROLINA TOBAR GARCIA,CAMARONES 3559,-34.616815,-58.488636,6,0,6,011
COMUNA 11,113,INST JUAN B JUSTO,LASCANO 3840,-34.613016,-58.496036,6,0,6,011
COMUNA 11,113,CLUB GIMNASIA Y ESGRIMA DE VELEZ SARSFIELD,JOAQUIN V GONZALEZ 1511,-34.619137,-58.489534,10,0,10,011
COMUNA 11,114,INST CARLOS STEEB,CAMARONES 3166,-34.614179,-58.483888,7,0,7,011
COMUNA 11,114,ESC N° 7 REP DE MEXICO,J A GARCIA 2755,-34.609384,-58.480392,6,3,9,011
COMUNA 11,114,ESC N° 7 JORGE NEWBERY,SAN BLAS 2962,-34.611829,-58.482124,7,0,7,011
COMUNA 11,114,ESC N° 17 C DE RODRIGUEZ PEÑA,MAGARINOS CERVANTES 2865,-34.613093,-58.47928,6,0,6,011
COMUNA 11,114,ESC N° 25 ALFREDO D ZUNDA,ESCALADA DE SAN MARTIN R DE 2986,-34.615989,-58.479168,10,0,10,011
COMUNA 11,114,ESC N° 8 QUINTINO BOCAYUVA,DIAZ CESAR GRAL 3050,-34.615459,-58.480877,3,4,7,011
COMUNA 11,114,CLUB IMPERIO JUNIORS,DIAZ CESAR GRAL 3047,-34.615427,-58.481029,10,0,10,011
COMUNA 11,115,ESC N° 14 ENRIQUE PARKER,CONDARCO 1129,-34.618861,-58.471802,4,0,4,011
COMUNA 11,115,ESC N° 4 PCIA DE LA PAMPA,CARACAS 1249,-34.616134,-58.467173,4,0,4,011
COMUNA 11,115,ESC INTEGRAL INTERDISCIPLINARIA N° 12,GAVILAN 1464,-34.61341,-58.467906,4,0,4,011
COMUNA 11,115,ESC N° 6 ALFREDO PALACIOS,CARACAS 2057,-34.607896,-58.47358,5,0,5,011
COMUNA 11,115,INST NTRA SRA DE LA SAGRADA FAMILIA,GRAL ARTIGAS 1276,-34.615958,-58.470611,8,3,11,011
COMUNA 11,115,CLUB VILLA GRAL MITRE,GAVILAN 1540,-34.612526,-58.468578,10,2,12,011
COMUNA 11,116,INST CABRINI,ESCALADA DE SAN MARTIN R DE 2059,-34.610069,-58.468183,7,0,7,011
COMUNA 11,116,ESC N°16 FRAY J SANTA MARIA DE ORO,ALVAREZ JONTE AV 1964,-34.603622,-58.471258,7,0,7,011
COMUNA 11,116,ESC N°18 COMODORO C URTUBEY,MAGARINOS CERVANTES 1556,-34.605307,-58.463034,7,0,7,011
COMUNA 11,116,ESC N°13 LEOPOLDO MARECHAL,GALICIA 1857,-34.611656,-58.463057,8,0,8,011
COMUNA 11,116,ESC N°9 JAPON,SANCHEZ 1858,-34.607,-58.465692,7,0,7,011
COMUNA 11,116,ESC N°17 SANTA MARIA DE LOS BS AS,FGTA SARMIENTO 1817,-34.604798,-58.459464,8,6,14,011
COMUNA 11,116,ESC FISHBACH,JUAN A GARCIA 2044,-34.605008,-58.471661,6,0,6,011
COMUNA 11,117,ESC N°21 ROMPEHIELOS GRAL SAN MARTIN,SANTO TOME 2836,-34.604393,-58.486277,7,0,7,011
COMUNA 11,117,ESC N°3 POLICIA FEDERAL ARGENTINA,ARGERICH 2849,-34.603559,-58.489633,6,0,6,011
COMUNA 11,117,ESC N°26 DELFINA MITRE DE VEDIA,CARACAS 2372,-34.605248,-58.475742,7,0,7,011
COMUNA 11,117,ESC N°10 ERNESTO GALLONI,HELGUERA 2435,-34.606754,-58.488874,5,0,5,011
COMUNA 11,117,ESC N°24 FRANCISCO BEIRO,BOLIVIA 2569,-34.604039,-58.481846,6,0,6,011
COMUNA 11,117,CLUB VILLA SAHORES,SANTO TOME 2496,-34.601481,-58.481298,8,0,8,011
COMUNA 11,117,CLUB RACING DE VILLA DEL PARQUE,HELGUERA 2841,-34.602671,-58.492338,10,2,12,011
COMUNA 11,117,CLUB RACING DE VILLA DEL PARQUE - ANEXO,HELGUERA Y NOGOYA,-34.603058,-58.492101,4,4,8,011
COMUNA 11,118,COLEGIO NUEVO PENSAR,NOGOYA 2620,-34.599979,-58.486716,4,0,4,011
COMUNA 11,118,INST SAN JOSE DE VILLA DEL PARQUE,PEDRO LOZANO 3151,-34.600944,-58.494651,7,3,10,011
COMUNA 11,118,ESC N°17 RODOLFO RIVAROLA,HELGUERA 3341,-34.598303,-58.495612,6,0,6,011
COMUNA 11,118,ESC N° 2 PROF JUAN JOSE MILLAN,HELGUERA 3228,-34.599576,-58.494758,7,0,7,011
COMUNA 11,118,ESC N°8 ALTE BLANCO ENCALADA,EMILIO LAMARCA 3379,-34.601166,-58.503306,6,0,6,011
COMUNA 11,118,INST EVANGELICO AMERICANO,HELGUERA 3246,-34.599169,-58.495064,7,0,7,011
COMUNA 11,118,ESC N°2 D F SARMIENTO,PEDRO LOZANO 3056,-34.600264,-58.49334,5,0,5,011
COMUNA 11,119,ESC N°1 DR DELLEPIANE,BAIGORRIA 3169,-34.604437,-58.492265,7,0,7,011
COMUNA 11,119,ESC TEC N°24 DEFENSA DE BUENOS AIRES,R GUTIERREZ 3246,-34.601788,-58.495741,6,3,9,011
COMUNA 11,119,CLUB GIMNASIA Y ESGRIMA DE VILLA DEL PARQUE,TINOGASTA 3455,-34.60254,-58.499126,8,0,8,011
COMUNA 11,119,CLUB EL ALBA,JOAQUIN V GONZALEZ 2469,-34.61053,-58.498881,11,0,11,011
COMUNA 11,119,CLUB PACIFICO,SANTO TOME 3851,-34.610942,-58.497786,13,0,13,011
COMUNA 11,119,COLEGIO SANTISIMA VIRGEN NIÑA,CUENCA 2651,-34.605135,-58.492236,7,0,7,011
COMUNA 11,120,CLUB SOCIAL Y DEPORTIVO PEDRO LOZANO,GUALEGUAYCHU 2902,-34.608506,-58.507396,9,0,9,011
COMUNA 11,120,COLEGIO N° 19 LUIS PASTEUR,NAVARRO 4344,-34.605394,-58.512916,3,0,3,011
COMUNA 11,120,VILLA DEVOTO SCHOOL,P MORAN 4447,-34.604786,-58.515816,8,0,8,011
COMUNA 11,120,ESC N°9 BENITO JUAREZ,BENITO JUAREZ 2702,-34.614446,-58.509859,7,0,7,011
COMUNA 11,120,ESC N°4 R RUIZ DE LOS LLANOS,BEIRO FRANCISCO AV 4548,-34.607782,-58.514792,9,0,9,011
COMUNA 11,120,UNION DEVOTO SOCIAL ALLENDE,MELINCUE 4656,-34.612893,-58.510468,9,0,9,011
COMUNA 11,120,ESC N°11 DR JOSE PERALTA,PEDRO LOZANO 4250,-34.608207,-58.506566,6,4,10,011
COMUNA 11,120,ESCUELA DEL MIRADOR,FERNANDEZ DE ENCISO 3565,-34.606273,-58.513415,4,0,4,011
COMUNA 11,121,ESC N°20 PEDRO MEDRANO,NUEVA YORK 4713,-34.605491,-58.520426,5,0,5,011
COMUNA 11,121,ESC N°16 PADRE A NORES,CNEL RAMON LISTA 5256,-34.614014,-58.523546,5,0,5,011
COMUNA 11,121,ESC N°19 BARTOLINA SISA,DEL CARRIL SALVADOR MARIA AV 4957,-34.606515,-58.523926,6,0,6,011
COMUNA 11,121,ESC N°22 PROF PEDRO L COMI,TINOGASTA 5046,-34.614025,-58.517755,5,0,5,011
COMUNA 11,121,INST SAN RAFAEL 2,SIMBRON 5275,-34.615921,-58.521537,5,0,5,011
COMUNA 11,121,ESC N° 6 ESTADO DE ISRAEL,P C DE LA BARCA 3073,-34.613731,-58.522537,5,0,5,011
COMUNA 11,121,ESCUELA HOGAR SAN RAFAEL,P C DE LA BARCA 3056,-34.613843,-58.522523,4,0,4,011
COMUNA 11,121,CLUB GRAL LAMADRID,DESAGUADERO 3120,-34.612874,-58.514699,9,3,12,011
COMUNA 11,122,INST NTRA SRA DE LA MISERICORDIA 2,ASUNCION 3780,-34.599281,-58.508555,4,0,4,011
COMUNA 11,122,ESC N° 3 ANTONIO DEVOTO,MERCEDES 4002,-34.600614,-58.512483,10,0,10,011
COMUNA 11,122,INST CARDENAL COPELLO,NUEVA YORK 3433,-34.595712,-58.504613,9,0,9,011
COMUNA 11,122,ESC N° 15 ANTONIO DEVOTO,NUEVA YORK 4169,-34.601166,-58.513342,5,2,7,011
COMUNA 11,122,EBDA BARTOLOMEO AYROLA,LINCOLN AV 4325,-34.598908,-58.515847,5,0,5,011
COMUNA 11,122,ESC N°23 ABEL AYERZA,DEL CARRIL SALVADOR MARIA AV 3650,-34.596923,-58.508067,6,0,6,011
COMUNA 11,123,ESC N° 1 DR DELFIN GALLO,FERNANDEZ DE ENCISO 4451,-34.594979,-58.511421,6,0,6,011
COMUNA 11,123,ESC N° 2 REP DE PANAMA,AV SAN MARTIN 6387,-34.593941,-58.50485,10,0,10,011
COMUNA 11,123,ESC N° 5 GABRIELA MISTRAL,JOSE L CABEZON 3446,-34.587371,-58.512324,5,0,5,011
COMUNA 11,123,ESC N° 15 REP DE VENEZUELA,OB SAN ALBERTO 3370,-34.586034,-58.511975,5,3,8,011
COMUNA 11,123,INST SAN JOSE 2,AV SAN MARTIN 6832,-34.592046,-58.51024,6,0,6,011
COMUNA 11,123,ESC N° 16 RICARDO ROJAS,GABRIELA MISTRAL 3376,-34.590945,-58.507591,5,0,5,011
COMUNA 11,123,ESC N°8 SAN JUAN BOSCO,MERCEDES 4966,-34.593342,-58.519105,5,0,5,011
COMUNA 12,124,ESC N°1 RODOLFO WALSH,ARGERICH 5651,-34.579514,-58.510266,6,0,6,012
COMUNA 12,124,INST DAMASA ZELAYA DE SAAVEDRA,AV ALBARELLOS 2367,-34.573907,-58.50378,10,2,12,012
COMUNA 12,124,ESC N°13 HILARION M MORENO,GRAL  ARTIGAS 5645,-34.576009,-58.50436,5,0,5,012
COMUNA 12,124,INST NTRA SRA DE LUJAN 3,COCHRANE 2371,-34.576091,-58.501995,4,0,4,012
COMUNA 12,124,ESC N°23 BELISARIO ROLDAN,FRANCO 2390,-34.577887,-58.500676,10,0,10,012
COMUNA 12,124,ESC N°22 REP DE NICARAGUA,BAZURCO 2551,-34.578267,-58.503263,8,0,8,012
COMUNA 12,124,INST POLITECNICO MODELO,DE LOS CONSTITUYENTES AV 5880,-34.573033,-58.503935,4,0,4,012
COMUNA 12,125,ESC N°17 G MATORRAS Y DEL SER DE SAN MARTIN,VALLEJOS 2555,-34.585309,-58.496806,8,0,8,012
COMUNA 12,125,INST NTRA SRA DEL HUERTO 2,AV GRAL MOSCONI 3022,-34.587538,-58.504107,7,4,11,012
COMUNA 12,125,ESC N°16 GRAL MOSCONI,MOSCONI GENERAL AV 2641,-34.584494,-58.499447,7,0,7,012
COMUNA 12,125,ESC N°2 AGUSTIN TOSCO,ZAMUDIO 4386,-34.585268,-58.494322,12,0,12,012
COMUNA 12,125,ESC N°19 T SANCHEZ DE BUSTAMANTE,GAVILAN 4246,-34.584733,-58.491269,9,0,9,012
COMUNA 12,125,COLEGIO RAICES,GAVILAN 4455,-34.583251,-58.4925,3,0,3,012
COMUNA 12,125,ESC N°24 EJERCITO ARGENTINO,NAZCA AV 5168,-34.582601,-58.505593,7,0,7,012
COMUNA 12,125,JARDIN DE INFANTES N°1 PROF L SIXTO CLARA,CUENCA 5049,-34.585741,-58.508773,3,2,5,012
COMUNA 12,125,ESC N°14 LEOPOLDO LUGONES,JURAMENTO 5775,-34.581822,-58.489724,7,0,7,012
COMUNA 12,126,ESC N°18 HELENA LARROQUE DE ROFFO,MEDEYROS 3555,-34.569313,-58.506814,8,0,8,012
COMUNA 12,126,ESC N°12 CARDENAL PACELLI,LARRALDE CRISOLOGO AV 5934,-34.566625,-58.502865,7,4,11,012
COMUNA 12,126,ESC N°17 GAUCHOS DE GÜEMES,J P TAMBORINI 5324,-34.567551,-58.494243,7,0,7,012
COMUNA 12,126,ESC N°9 REP DE IRLANDA,IBERA 5734,-34.570939,-58.497878,6,0,6,012
COMUNA 12,126,CLUB SOC Y DEP SIN RUMBO,J P TAMBORINI 6157,-34.57253,-58.503764,3,0,3,012
COMUNA 12,126,ESC N°6 LUIS PASTEUR,NAHUEL HUAPI 5740,-34.575376,-58.496252,7,0,7,012
COMUNA 12,126,CLUB PENACHO AZUL,J P TAMBORINI 5676,-34.569498,-58.497903,8,0,8,012
COMUNA 12,126,CLUB RIO DE LA PLATA,IBERA 5257,-34.567993,-58.49251,5,0,5,012
COMUNA 12,127,CLUB CIRCULO GRAL URQUIZA,F D ROOSEVELT 5345,-34.575076,-58.490075,5,0,5,012
COMUNA 12,127,ESC N°10 DR RAMON J CARCANO,BUCARELLI 1950,-34.580086,-58.48443,7,0,7,012
COMUNA 12,127,INST TOMAS DEVOTO,F D ROOSEVELT 5678,-34.577214,-58.493443,8,0,8,012
COMUNA 12,127,COLEGIO N°12 RECONQUISTA,AV TRIUNVIRATO 4992,-34.572497,-58.488838,8,5,13,012
COMUNA 12,127,INST BEATA IMELDA,ANDONAEGUI 2261,-34.577584,-58.488729,7,0,7,012
COMUNA 12,127,INST BEATA IMELDA - GIMNASIO,OLAZABAL 5253,-34.577621,-58.487992,8,0,8,012
COMUNA 12,127,COLEGIO SAN FRANCISCO COLL,BAUNESS 2635,-34.573142,-58.489127,5,4,9,012
COMUNA 12,127,ESC N°9 DOMINGUITO,ECHEVERRIA 5034,-34.578749,-58.480651,8,0,8,012
COMUNA 12,127,INST SAGRADA FAMILIA 2,BLANCO ENCALADA 5154,-34.576043,-58.487148,9,0,9,012
COMUNA 12,127,COLEGIO SAINT JEAN,MONROE 5352,-34.575815,-58.488867,5,0,5,012
COMUNA 12,128,ESC N°1 CORONEL OLAVARRIA,TRIUNVIRATO AV 5101,-34.57143,-58.489917,9,0,9,012
COMUNA 12,128,ESC N°11 FRAY LUIS BELTRAN,CAPDEVILA 3156,-34.568221,-58.49155,7,0,7,012
COMUNA 12,128,ESC N°3 REP DE COSTA RICA,M PEDRAZA 4548,-34.56191,-58.485521,6,3,9,012
COMUNA 12,128,CLUB PINOCHO,M PEDRAZA 5141,-34.564727,-58.491658,8,0,8,012
COMUNA 12,128,ST PATRICK S SCHOOL - PRIMARIA,NAHUEL HUAPI 4141,-34.565697,-58.479222,4,2,6,012
COMUNA 12,128,COLEGIO CRISTO REY,QUESADA 5228,-34.569089,-58.491447,7,0,7,012
COMUNA 12,128,ESC N°24 FRANCISCO MORAZAN,DR P I RIVERA 4223,-34.567162,-58.479247,3,0,3,012
COMUNA 12,128,CLUB SUNDERLAND,LUGONES 3161,-34.564929,-58.484998,6,0,6,012
COMUNA 12,128,INST SUP DEL PROFESORADO EN ED ESPECIAL,HOLMBERG 2754,-34.566621,-58.479335,3,0,3,012
COMUNA 12,128,INST DULCISIMO NOMBRE DE JESUS,LARRALDE CRISOLOGO AV 4841,-34.560561,-58.490497,5,0,5,012
COMUNA 12,129,ESC N°2 JUANA MANUELA GORRITI,TRIUNVIRATO AV 4857,-34.573133,-58.487711,10,8,18,012
COMUNA 12,129,UBA CBC SEDE DRAGO,HOLMBERG 2614,-34.567655,-58.478471,12,0,12,012
COMUNA 12,129,ESC N°21 LIC JUSTO J NUÑEZ,ACHA MARIANO GRAL 2250,-34.572218,-58.477183,6,0,6,012
COMUNA 12,129,ESC N°4 PCIA DE BUENOS AIRES,ALVAREZ THOMAS AV 3391,-34.570438,-58.484148,6,0,6,012
COMUNA 12,129,ESC N°18 JOSE HERNANDEZ,LA PAMPA 3855,-34.573154,-58.468626,8,0,8,012
COMUNA 12,129,COLEGIO HORACIO WATSON,DIAZ COLODRERO 2431,-34.573466,-58.48567,7,0,7,012
COMUNA 12,129,INST SAN VICENTE PALLOTI,ESTOMBA 1942,-34.572024,-58.470292,3,0,3,012
COMUNA 12,129,SEDE COMUNAL 12,HOLMBERG 2548,-34.56851,-58.477729,3,0,3,012
COMUNA 12,129,ESC N°16 EJERCITO DE LOS ANDES,TRIUNVIRATO AV 4247,-34.577903,-58.480665,6,0,6,012
COMUNA 12,129,INST HIJAS DE JESUS,OLAZABAL 3849,-34.569101,-58.473366,3,0,3,012
COMUNA 12,129,INST CEFERINO NAMUNCURA,PACHECO 2059,-34.576126,-58.481124,4,0,4,012
COMUNA 12,129,ESC N°8 JORGE A BOERO,JURAMENTO 4849,-34.575795,-58.480006,8,0,8,012
COMUNA 12,130,ESC N°22 FELIX DE AZARA,JOSE P TAMBORINI 3948,-34.56073,-58.480203,12,0,12,012
COMUNA 12,130,INST SANTA CLARA DE ASIS,M PEDRAZA 3850,-34.558521,-58.478945,9,0,9,012
COMUNA 12,130,INST SANTA MARIA DE LOS ANGELES,M PEDRAZA 3978,-34.559204,-58.48021,12,4,16,012
COMUNA 12,130,INST NTRA SRA DEL CARMEN - GIMNASIO,MELIAN AV 2753,-34.563058,-58.473521,6,0,6,012
COMUNA 12,130,ESC N°15 MANUEL A ACEVEDO,TRONADOR 2861,-34.564529,-58.478732,7,0,7,012
COMUNA 12,130,ESC N°21 FRAGATA ESCUELA LIBERTAD,NUNEZ 3620,-34.556144,-58.478138,6,0,6,012
COMUNA 12,131,ESC N°19 NACIONES UNIDAS,R YRURTIA 5806,-34.563464,-58.502326,6,0,6,012
COMUNA 12,131,ESC N°12 ESPAÑA,VALDENEGRO 3525 ,-34.561659,-58.490366,6,0,6,012
COMUNA 12,131,ESC N°15 DRA CECILIA GRIERSON,VALDENEGRO 3523,-34.561678,-58.490353,5,1,6,012
COMUNA 12,132,ESC N°25 REP DE TURQUIA,RUIZ HUIDOBRO 3853,-34.550689,-58.486494,9,0,9,012
COMUNA 12,132,ESC N°14 F M DEL BARCO CENTENERA,ROQUE PEREZ 3545,-34.555563,-58.478158,8,0,8,012
COMUNA 12,132,ESC N°14 DR VICENTE CARMELO GALLO,DEHEZA 4728,-34.551368,-58.495517,10,0,10,012
COMUNA 12,132,ESC N°5 MONSEÑOR E ANGELELLI,TRONADOR 4134,-34.552703,-58.486795,5,0,5,012
COMUNA 12,132,ESC N°13 DR I L ALBARRACIN,ACHA MARIANO GRAL 4452,-34.55266,-58.492919,7,0,7,012
COMUNA 12,132,ESC N°18 J B TERAN,ARIAS 4763,-34.552207,-58.495235,7,0,7,012
COMUNA 12,132,INST SANTA MARIA DE NAZARETH,BALBIN RICARDO DR AV 4131,-34.554955,-58.489788,3,6,9,012
COMUNA 12,132,INST LA SALETTE,ROQUE PEREZ Y RUIZ HUIDOBRO,-34.549116,-58.483093,4,0,4,012
COMUNA 12,132,CLUB ESTUDIANTES DEL NORTE,HOLMBERG 4070,-34.55429,-58.488038,6,0,6,012
COMUNA 12,133,ESC N°15 PCIA DE SANTA FE,PICO 2629,-34.541361,-58.476278,10,5,15,012
COMUNA 12,133,ESC N°21 CNEL C SAAVEDRA,FREIRE 4080,-34.549119,-58.478911,12,0,12,012
COMUNA 12,133,INST SAN ISIDRO LABRADOR,SAN ISIDRO LABRADOR AV 4700,-34.541958,-58.474586,6,0,6,012
COMUNA 12,133,INST SAN FRANCISCO DE ASIS,LARRALDE CRISOLOGO AV 2551,-34.549705,-58.469631,6,0,6,012
COMUNA 12,133,INST SAN FRANCISCO DE ASIS - GIMNASIO,CIUDAD DE LA PAZ 3646,-34.549227,-58.46963,6,0,6,012
COMUNA 12,133,COLEGIO DIVINA PROVIDENCIA,ARIAS 2915,-34.543969,-58.478491,7,0,7,012
COMUNA 12,133,ESC N°13 RICARDO MONNER SANS,RUIZ HUIDOBRO 2643,-34.545442,-58.474285,6,0,6,012
COMUNA 12,133,ESC N°6 CNEL M DORREGO,BESARES 2990,-34.54711,-58.476147,6,0,6,012
COMUNA 13,134,COLEGIO LOMAS DE NUÑEZ,ARCOS 4531,-34.540458,-58.47029,3,0,3,013
COMUNA 13,134,ESCUELAS TECNICAS RAGGIO,AV DEL LIBERTADOR 8635,-34.536109,-58.466496,19,0,19,013
COMUNA 13,134,CLUB NAUTICO BUCHARDO,"Rivadavia Martin, Comodoro AV 1250",-34.53827,-58.459851,4,2,6,013
COMUNA 13,135,INST AULA XXI,11 DE SEPTIEMBRE DE 1888 3168,-34.549042,-58.458948,8,0,8,013
COMUNA 13,135,INST BELGRANO UNO,ARRIBENOS 2871,-34.551052,-58.456042,4,0,4,013
COMUNA 13,135,ESC N°10 JOAQUIN M CULLEN,11 DE SEPTIEMBRE DE 1888 3451,-34.546736,-58.460533,8,4,12,013
COMUNA 13,135,COLEGIO OAK HILL,PADRE CANAVERY 7557,-34.542422,-58.45524,5,0,5,013
COMUNA 13,135,INST DR ENRIQUE ROMERO BREST,MIGUEL SANCHEZ 1338 ,-34.543469,-58.457154,10,0,10,013
COMUNA 13,136,ESC N°9 EVARISTO JULIO BADIA,O HIGGINS 3050,-34.551067,-58.460882,10,0,10,013
COMUNA 13,136,ESC N°7 MANUEL J GARCIA,CABILDO AV 3615,-34.549398,-58.467644,8,4,12,013
COMUNA 13,136,ESC N°7 MANUEL J GARCIA - GIMNASIO,CABILDO AV 3631,-34.549342,-58.467688,9,0,9,013
COMUNA 13,136,INST GRAL SAN MARTIN - PRIMARIA,CUBA 3302,-34.550096,-58.464577,3,0,3,013
COMUNA 13,136,ESCUELA DEL JACARANDA,M PEDRAZA 1892,-34.549044,-58.461766,3,2,5,013
COMUNA 13,136,ESC INTEGRAL INTERDISCIPLINARIA N°10,O HIGGINS 3401,-34.54875,-58.463262,9,0,9,013
COMUNA 13,137,ESC N°12 RODOLFO SENET,CRAMER 3271,-34.55445,-58.470216,17,0,17,013
COMUNA 13,137,ESC N°16 REP DOMINICANA,CONGRESO AV 3045,-34.558608,-58.468707,12,2,14,013
COMUNA 13,137,INST GRAL SAN MARTIN - SECUNDARIA,IBERA 2351,-34.553196,-58.463996,3,0,3,013
COMUNA 13,137,ESCUELA DE LA ALDEA,NUNEZ 2776,-34.552006,-58.47073,3,2,5,013
COMUNA 13,137,ESC N°4 CNEL BRANDSEN,JUANA AZURDUY 2541,-34.551688,-58.468299,5,0,5,013
COMUNA 13,138,ESC N°19 PABLO PIZZURNO,MONROE 3000,-34.561617,-58.465406,16,0,16,013
COMUNA 13,138,ESC N°5 HEROES DE MALVINAS,CRAMER 2136,-34.56453,-58.461634,17,0,17,013
COMUNA 13,138,ESC N°7 MANUEL BELGRANO,MONROE 3061,-34.561822,-58.465979,16,4,20,013
COMUNA 13,138,ESC ARGENTINA GENERAL BELGRANO,AV MONROE 3021,-34.561663,-58.465712,4,0,4,013
COMUNA 13,138,INST NTRA SRA DEL SAGRADO CORAZON,BLANCO ENCALADA 2942,-34.562282,-58.464187,8,2,10,013
COMUNA 13,138,BELGRANO DAY SCHOOL,MENDOZA 3036,-34.564608,-58.463373,5,0,5,013
COMUNA 13,138,ESC N°5 JUAN B ALBERDI,MOLDES 2043,-34.56411,-58.459023,12,10,22,013
COMUNA 13,138,ESC N°5 JUAN B ALBERDI - COMEDOR,AMENABAR 2060,-34.563565,-58.458258,4,0,4,013
COMUNA 13,139,ESC N°28 REP FRANCESA,CUBA 2410,-34.5579,-58.457417,11,0,11,013
COMUNA 13,139,ESC N°17 JUAN BALESTRA,ARCOS 2440,-34.557161,-58.456682,11,0,11,013
COMUNA 13,139,ESC N°10 J B ALBERDI,O HIGGINS 2441,-34.556576,-58.45573,17,6,23,013
COMUNA 13,139,ESC N°1 CASTO MUNITA,CUBA 2039,-34.561559,-58.454143,14,0,14,013
COMUNA 13,140,COLEGIO OXFORD,CONGRESO AV 1570,-34.551003,-58.453851,5,0,5,013
COMUNA 13,140,ESC N°22 R DE ESCALADA DE SAN MARTIN,F D ROOSEVELT 1510,-34.552323,-58.451751,8,0,8,013
COMUNA 13,140,UNITED HIGH SCHOOL,MONTANESES 2434,-34.554301,-58.451625,5,0,5,013
COMUNA 13,140,INST PORTEÑO,MONTANESES 1936,-34.558943,-58.447618,3,2,5,013
COMUNA 13,140,ESC N°20 VICEALMIRANTE MONTES,CONGRESO AV 1553,-34.550859,-58.453805,4,3,7,013
COMUNA 13,141,ESC N°8 ALTE R GONZALEZ FERNANDEZ,MENDOZA 1000,-34.552433,-58.442881,13,0,13,013
COMUNA 13,141,ESCUELA ITALIANA CRISTOFORO COLOMBO,RAMSAY 2251,-34.5507,-58.441048,8,0,8,013
COMUNA 13,141,INST SAN ROMAN - PRIMARIA,JURAMENTO 1368,-34.555907,-58.446315,6,0,6,013
COMUNA 13,141,UNIVERSIDAD TORCUATO DI TELLA,FIGUEROA ALCORTA  AV 7350,-34.547192,-58.446679,8,4,12,013
COMUNA 13,141,INST RIVER PLATE,AV UDAONDO Y AV FIGUEROA ALCORTA,-34.546286,-58.452126,8,0,8,013
COMUNA 13,142,INST NTRA SRA DE LA MISERICORDIA 3,CABILDO AV 1333,-34.567564,-58.449349,10,0,10,013
COMUNA 13,142,INST MANUEL BELGRANO,LA PAMPA 2226,-34.563986,-58.452652,15,0,15,013
COMUNA 13,142,INST SAN ROMAN - SECUNDARIA,MIGUELETES 2039,-34.556527,-58.446199,9,0,9,013
COMUNA 13,142,ESC N°23 JOSE C PAZ,A J DE SUCRE 1367,-34.557695,-58.444608,9,0,9,013
COMUNA 13,142,CLUB ATLETICO EXCURSIONISTAS,LA PAMPA 1376,-34.558497,-58.443378,6,0,6,013
COMUNA 13,142,INST NTRA SRA DEL ROSARIO,C DE LA PAZ 1839,-34.56495,-58.455609,6,4,10,013
COMUNA 13,142,SOCIEDAD ESPAÑOLA DE SOCORROS MUTUOS,CIUDAD DE LA PAZ 1750,-34.565894,-58.454913,7,2,9,013
COMUNA 13,142,NUEVA ESC ARGENTINA 2000 - PRIMARIA,VIDAL 1838,-34.566674,-58.45827,6,0,6,013
COMUNA 13,143,INST SAN CAYETANO 2,MOLDES 1764,-34.566891,-58.456737,4,0,4,013
COMUNA 13,143,ESC N°3 ESTEBAN ECHEVERRIA,MOLDES 1858,-34.566019,-58.457488,16,2,18,013
COMUNA 13,143,INST PATROCINIO DE SAN JOSE - GIMNASIO,LA PAMPA 3023,-34.568286,-58.460218,8,0,8,013
COMUNA 13,143,INST PATROCINIO DE SAN JOSE,CONESA 1830,-34.567736,-58.460334,5,0,5,013
COMUNA 13,143,LICEO N°9 SANTIAGO DERQUI,CONESA 1855,-34.567691,-58.460263,10,4,14,013
COMUNA 13,143,NUEVA ESC ARGENTINA 2000 - SECUNDARIA,VIDAL 1861,-34.566511,-58.458298,3,0,3,013
COMUNA 13,143,COLEGIO DE LA CIUDAD,MOLDES 1825,-34.566202,-58.457221,3,0,3,013
COMUNA 13,143,ESC N°3 ESTEBAN ECHEVERRIA - GIMNASIO,VIDAL 1863,-34.566509,-58.4583,6,0,6,013
COMUNA 13,144,BUENOS AIRES ENGLISH HIGH SCHOOL,MELIAN AV 1854,-34.570717,-58.465465,8,0,8,013
COMUNA 13,144,COLEGIO ST BRENDAN S,SUPERI 2057,-34.568323,-58.466085,3,2,5,013
COMUNA 13,144,COLEGIO ST BRENDAN S - GIMNASIO,ECHEVERRIA 3343,-34.568422,-58.46519,5,0,5,013
COMUNA 13,144,COLEGIO SWORN JUNIOR,V DEL PINO 3275,-34.57094,-58.461669,3,0,3,013
COMUNA 13,144,COLEGIO PESTALOZZI,FREIRE 1882,-34.568697,-58.462653,4,0,4,013
COMUNA 13,145,ESC N°7 MARCOS SASTRE,VIRREY LORETO 3050,-34.573555,-58.454704,8,4,12,013
COMUNA 13,145,ESC N°17 MONSEÑOR FRANCESCHI,GRAL E MARTINEZ 1432,-34.575198,-58.460769,8,0,8,013
COMUNA 13,145,CLUB SOC Y DEP JUVENTUD DE BELGRANO,VIRREY AVILES 3167,-34.573208,-58.458544,8,0,8,013
COMUNA 13,145,ST CATHERINE S SCHOOL,CARBAJAL 3250,-34.571579,-58.460597,4,0,4,013
COMUNA 13,145,COLEGIO MEKHITARISTA,V DEL PINO 3511,-34.572684,-58.464949,3,0,3,013
COMUNA 13,145,COLEGIO N°8 JULIO A ROCA,ZUBERBUHLER 1850,-34.569421,-58.45974,13,0,13,013
COMUNA 13,146,ESC N°13 R SCALABRINI ORTIZ,CONDE 223,-34.580226,-58.445443,13,3,16,013
COMUNA 13,146,COLEGIO SANTO TOMAS DE AQUINO 2,FREIRE 183,-34.579312,-58.444584,7,0,7,013
COMUNA 13,146,COLEGIO INDUSTRIAL LEON XIII,C ARENAL 2774,-34.577532,-58.44062,13,0,13,013
COMUNA 13,147,COLEGIO ST MATTHEW S,MOLDES 1469,-34.568692,-58.454467,3,0,3,013
COMUNA 13,147,ESC N°16 CAPITAN MOYANO,MOLDES 1102,-34.570635,-58.451214,8,0,8,013
COMUNA 13,147,COLEGIO HANS CHRISTIAN ANDERSEN,C DE LA PAZ 1282,-34.568779,-58.450789,8,0,8,013
COMUNA 13,147,ESC N°3 JUANA MANSO,ZAPATA 449,-34.572652,-58.442248,12,0,12,013
COMUNA 13,147,JARDIN DE INFANTES N°9 JARDIN DEL SOL,MOLDES 1220,-34.57004,-58.452243,3,0,3,013
COMUNA 13,147,INST ESPAÑOL VIRGEN DEL PILAR,LACROZE FEDERICO AV 2950,-34.575331,-58.44788,7,4,11,013
COMUNA 13,147,ESC N°15 GRAL B O HIGGINS,LACROZE FEDERICO AV 2971,-34.575568,-58.448235,6,4,10,013
COMUNA 13,147,ESCUELA DEL SOL,CRAMER 450,-34.57504,-58.444562,4,0,4,013
COMUNA 13,147,ESC N°12 GRAN MCAL DEL PERU RAMON CASTILLA,CONDE 943,-34.576542,-58.452345,8,0,8,013
COMUNA 14,148,ESC N°10 MANUEL LAINEZ,OLLEROS 2325,-34.569531,-58.443275,6,0,6,014
COMUNA 14,148,UB FACULTAD DE INGENIERIA,VILLANUEVA 1324,-34.565505,-58.442697,3,0,3,014
COMUNA 14,148,ESC N°10 MANUEL LAINEZ - SUM,LACROZE FEDERICO AV 2322,-34.569087,-58.443942,6,0,6,014
COMUNA 14,148,INST SANTA MARIA DE LUJAN,3 DE FEBRERO 760,-34.571012,-58.440456,5,0,5,014
COMUNA 14,148,ESC N°6 VICENTE FIDEL LOPEZ,SANTA FE AV 5039,-34.576706,-58.430806,15,0,15,014
COMUNA 14,148,ESC N°3 M SANCHEZ DE THOMPSON,CABILDO AV 40,-34.574779,-58.436339,5,3,8,014
COMUNA 14,148,INST ESQUIU,3 DE FEBRERO 1261,-34.567571,-58.444913,6,0,6,014
COMUNA 14,148,COLEGIO LINCOLN,OLLEROS 2283,-34.569056,-58.442746,5,0,5,014
COMUNA 14,148,INST CORAZON DE JESUS,C ARENAL 2357,-34.573724,-58.436795,5,4,9,014
COMUNA 14,148,INST PRIVADO COLEGIO MASTER,OLLEROS 2110,-34.567986,-58.44142,4,0,4,014
COMUNA 14,148,COLEGIO ESCLAVAS DEL SAGRADO CORAZON,MAURE 1944,-34.568645,-58.437731,5,0,5,014
COMUNA 14,149,ESC N°5 HONORABLE CONGRESO DE LA NACION,DEL LIBERTADOR AV 4777,-34.564755,-58.434259,8,0,8,014
COMUNA 14,149,ESC N°3 GRANADEROS DE SAN MARTIN - PRIMARIA,DEL LIBERTADOR AV 4903,-34.564095,-58.435383,10,0,10,014
COMUNA 14,149,ESC N°3 GRANADEROS DE SAN MARTIN - GIMNASIO,AV DEL LIBERTADOR 4903,-34.564095,-58.435383,6,0,6,014
COMUNA 14,149,INST HOGAR SAN BENITO,ARCE 322,-34.571034,-58.430769,3,0,3,014
COMUNA 14,149,ESC N° 8 ARMENIO ARGENTINA - SUM,ARCE 611,-34.569162,-58.433812,7,9,16,014
COMUNA 14,149,WASHINGTON SCHOOL,LACROZE FEDERICO AV 1973,-34.566083,-58.441214,6,0,6,014
COMUNA 14,149,ESC N°8 ARMENIO ARGENTINA,ARCE 611,-34.569162,-58.433812,9,0,9,014
COMUNA 14,149,CLUB HARRODS GATH Y CHAVES,V DEL PINO 1480,-34.56094,-58.442718,10,0,10,014
COMUNA 14,149,CLUB GEBA - SEDE SAN MARTIN,DE LOS OMBUES AV Y FIGUEROA ALCORTA AV ,-34.559284,-58.427359,10,0,10,014
COMUNA 14,149,JARDIN DE INFANTES N°2 - GRANADEROS DE SAN MARTIN,DEL LIBERTADOR AV 4953,-34.563778,-58.43591,5,0,5,014
COMUNA 14,150,INST SUPERIOR ECCLESTON,DORREGO AV 3751,-34.562975,-58.416964,10,4,14,014
COMUNA 14,150,INST SAN MARTIN DE TOURS,FIGUEROA ALCORTA  AV 3380,-34.577913,-58.403242,6,0,6,014
COMUNA 14,150,INST BAYARD - PRIMARIA,J SALGUERO 2969,-34.578092,-58.406221,3,0,3,014
COMUNA 14,150,INST BAYARD - SECUNDARIA,CASTEX 3348,-34.578141,-58.405577,4,0,4,014
COMUNA 14,150,JARDIN DE INFANCIA MITRE,DORREGO AV 3723,-34.564752,-58.41918,11,0,11,014
COMUNA 14,150,INST SAN MARTIN DE TOURS 2,ZENTENO 3160,-34.579953,-58.403601,4,0,4,014
COMUNA 14,151,LA RURAL S A,SARMIENTO AV 2704,-34.57551,-58.415653,42,0,42,014
COMUNA 14,151,CENTRO CENTES N°2,JUAN F SEGUI 3755,-34.578147,-58.411225,5,3,8,014
COMUNA 14,151,ESC DE JARDINERIA CRISTOBAL M HICKEN,LAS HERAS GRAL AV 4078,-34.581685,-58.417028,8,0,8,014
COMUNA 14,151,INST LANGE LEY,SCALABRINI ORTIZ RAUL AV 2840,-34.58313,-58.412927,9,0,9,014
COMUNA 14,151,ESC N°2 OSVALDO MAGNASCO,SANTA FE AV 3727,-34.584848,-58.416254,3,6,9,014
COMUNA 14,151,ESC N° 17 ARMINDA ABERASTURY,SCALABRINI ORTIZ RAUL AV 2760,-34.583731,-58.413864,3,1,4,014
COMUNA 14,151,CENTRO EDUCATIVO SANTA ELENA,LAFINUR 3331,-34.577265,-58.412235,6,0,6,014
COMUNA 14,152,ESC N°26 ADOLFO VAN GELDEREN,J SALGUERO 2455,-34.583836,-58.41055,10,0,10,014
COMUNA 14,152,COLEGIO SANTA TERESA DE JESUS - PRIMARIA,LAS HERAS GRAL AV 3670,-34.582115,-58.410998,6,0,6,014
COMUNA 14,152,ESC N°16 WENCESLAO POSSE,JUNCAL 3131,-34.585775,-58.40907,6,7,13,014
COMUNA 14,152,ESC N°8 EN LENGUAS VIVAS,JUNCAL 3251,-34.585437,-58.41013,14,0,14,014
COMUNA 14,152,ESC N°12 GENERAL LAS HERAS,JULIAN ALVAREZ 2849,-34.584279,-58.411151,6,0,6,014
COMUNA 14,152,JARDIN DE INFANTES N° 3,JUNCAL 3185,-34.585775,-58.40907,4,0,4,014
COMUNA 14,152,SEDE COMUNAL N° 14,BERUTI 3325,-34.587236,-58.409438,5,0,5,014
COMUNA 14,152,COLEGIO CHILDREN´S,CHARCAS 3949,-34.586511,-58.419256,7,0,7,014
COMUNA 14,153,INST CORAZON DE MARIA,GUISE 1979,-34.590435,-58.412544,3,0,3,014
COMUNA 14,153,INST CORAZON DE MARIA - SUM,GUISE 1965,-34.590435,-58.412544,6,0,6,014
COMUNA 14,153,ESC N°6 VICENTE LOPEZ Y PLANES,GUEMES 3837,-34.587093,-58.415956,12,0,12,014
COMUNA 14,153,COLEGIO GUADALUPE,PARAGUAY 3925,-34.589396,-58.41806,8,5,13,014
COMUNA 14,153,COLEGIO DEL DIVINO CORAZON,REP DOMINICANA 3586,-34.589844,-58.41523,15,5,20,014
COMUNA 14,153,ESC N°4 AMADEO JACQUES,SOLER 3929,-34.591856,-58.417256,6,0,6,014
COMUNA 14,153,INST GONZALEZ PECOTCHE - SECUNDARIA,DIAZ CNEL AV 1774,-34.59074,-58.41163,3,0,3,014
COMUNA 14,153,ESC N°5 U LLAMES DE LA PUENTE,L N MANSILLA 3643,-34.590775,-58.414935,8,0,8,014
COMUNA 14,153,INST GONZALEZ PECOTCHE - PRIMARIA,VIDT 1631,-34.591741,-58.416465,6,0,6,014
COMUNA 14,154,ESC N°20 CARLOS M BIEDMA,GUEMES 4610,-34.581324,-58.424082,9,0,9,014
COMUNA 14,154,ESC N°17 BLAS PARERA,ARMENIA 2214,-34.585965,-58.422092,6,10,16,014
COMUNA 14,154,ESC N°11 MANUELA PEDRAZA,MALABIA 2252,-34.586562,-58.420714,7,6,13,014
COMUNA 14,154,INST AMBROSIO TOGNONI,SANTA FE AV 4320,-34.580449,-58.42294,6,5,11,014
COMUNA 14,154,ESC N°7 MARIA CLAUDIA FALCONE,MALABIA 2148,-34.587423,-58.422051,6,0,6,014
COMUNA 14,154,COLEGIO ARMONIA,THAMES 2472,-34.581576,-58.422293,3,0,3,014
COMUNA 14,154,CENTRO ED SAN FRANCISCO JAVIER - PRIMARIA,J L BORGES 1883,-34.586942,-58.427357,3,0,3,014
COMUNA 14,154,CENTRO ED SAN FRANCISCO JAVIER - SECUNDARIA,J L BORGES 1851,-34.587063,-58.427544,6,0,6,014
COMUNA 14,154,COLEGIO PALERMO CHICO,GUATEMALA 4892,-34.585006,-58.42622,6,4,10,014
COMUNA 14,154,ESC N°1 REP DE CUBA,COSTA RICA 4942,-34.586435,-58.429704,5,0,5,014
COMUNA 14,154,ESC N° 26 DR JORGE GARBER,DARREGUEYRA 2460,-34.580317,-58.424063,5,0,5,014
COMUNA 14,154,MIN DE CIENCIA Y TECNOLOGIA DE LA NACION,GODOY CRUZ 2320,-34.582612,-58.428722,6,0,6,014
COMUNA 14,154,CENTRO CULTURAL DE LA CIENCIA,GODOY CRUZ 2270,-34.582983,-58.429047,8,0,8,014
COMUNA 14,155,ESC N°14 PCIA DE RIO NEGRO,AREVALO 1408,-34.583435,-58.443369,7,4,11,014
COMUNA 14,155,ESC N°9 JUAN C LAFINUR,GORRITI 5740,-34.583805,-58.438771,7,0,7,014
COMUNA 14,155,COLEGIO N° 4 NICOLAS AVELLANEDA - GIMNASIO,EL SALVADOR 5528,-34.583904,-58.434757,9,0,9,014
COMUNA 14,155,COLEGIO N° 4 NICOLAS AVELLANEDA,EL SALVADOR 5528,-34.583904,-58.434757,6,5,11,014
COMUNA 14,155,COLEGIO FASTA CATHERINA,SOLER 5942,-34.578242,-58.436,7,0,7,014
COMUNA 14,155,ESC FRANCESCO FAA DI BRUNO,BONPLAND 1999,-34.581028,-58.434606,6,4,10,014
COMUNA 14,155,ESC N°31 NACIONES UNIDAS,ANGEL J CARRANZA 2045,-34.579715,-58.435034,6,0,6,014
COMUNA 14,155,COLEGIO ST XAVIER - SECUNDARIA,GORRITI 5980,-34.58225,-58.440847,3,0,3,014
COMUNA 14,155,ESC N° 4 DR RAFAEL LUIS ARCONE,NICARAGUA 5732,-34.58067,-58.434869,5,0,5,014
COMUNA 14,155,CENTRO DE DIA N° 9 Y 13,PARAGUAY 5170,-34.579759,-58.430634,3,0,3,014
COMUNA 14,155,CLUB SOC Y DEP ESTRELLA DE MALDONADO,HUMBOLDT 1731,-34.584458,-58.434835,6,0,6,014
COMUNA 14,155,ESC FRANCESCO FAA DI BRUNO - GIMNASIO,NICARAGUA 5664,-34.581439,-58.433886,5,0,5,014
COMUNA 14,156,INST MARIE MANOOGIAN,ARMENIA 1338,-34.591842,-58.431025,4,0,4,014
COMUNA 14,156,ESC PRIMARIA DIARBEKIRIAN,VEGA NICETO CNEL 4753,-34.592503,-58.430885,5,0,5,014
COMUNA 14,156,ESC N°23 DR JOSE MARIA BUSTILLO,THAMES 1361,-34.589763,-58.433595,3,5,8,014
COMUNA 14,156,INST GASCON - SUM,GURRUCHAGA 1254,-34.591745,-58.433057,6,0,6,014
COMUNA 14,156,INST GASCON,SERRANO 1261,-34.591105,-58.433746,5,0,5,014
COMUNA 14,156,CLUB SOCIAL Y DEPORTIVO EROS,URIARTE 1609,-34.587365,-58.431845,5,0,5,014
COMUNA 14,157,ESC N°9 CNEL GENARO BERON DE ASTRADA,EL SALVADOR 4037,-34.592726,-58.419949,7,5,12,014
COMUNA 14,157,ESC N°4 PCIA DE CORDOBA,SCALABRINI ORTIZ RAUL AV 1336,-34.59263,-58.427715,11,0,11,014
COMUNA 14,157,CEAES ESPIRITU SANTO,ACUNA DE FIGUEROA 1742,-34.590952,-58.420423,12,0,12,014
COMUNA 14,157,UP - FACULTAD DE DERECHO,MARIO BRAVO 1050,-34.597323,-58.415844,3,0,3,014
COMUNA 14,157,UP - FACULTAD DE DISEÑO Y COMUNICACION 2,CABRERA JOSE ANTONIO 3641,-34.596561,-58.417713,8,0,8,014
COMUNA 14,157,NEW MODEL INTERNATIONAL SCHOOL,EL SALVADOR 3952,-34.59282,-58.418719,6,4,10,014
COMUNA 15,158,ESC N°18 YAPEYU,MALABIA 964,-34.595018,-58.433634,15,3,18,015
COMUNA 15,158,INST PRIV DE LA COLECTIVIDAD HELENICA,JULIAN ALVAREZ 1030,-34.596195,-58.429253,5,3,8,015
COMUNA 15,158,INST GRIEGO ATENAGORAS I,LERMA 242,-34.596181,-58.430235,7,2,9,015
COMUNA 15,158,INST SAN JOSE DE LA PALABRA DE DIOS,CASTILLO 767,-34.593225,-58.436282,10,0,10,015
COMUNA 15,158,ESC N°1 T DE LA QUINTANA ESCALADA,CORRIENTES AV 5332,-34.598704,-58.440057,11,0,11,015
COMUNA 15,158,ESC INTEGRAL INTERDISCIPLINARIA N°2,CABRERA JOSE ANTONIO 4078,-34.596302,-58.423976,9,0,9,015
COMUNA 15,159,ESC N°2 AUSTRALIA,GURRUCHAGA 739,-34.595398,-58.438639,5,0,5,015
COMUNA 15,159,ESC N°19 PCIA DE CHUBUT,HUMBOLDT 742,-34.592346,-58.444673,5,2,7,015
COMUNA 15,159,INST INTEGRAL MUNDO NUEVO,SERRANO 557,-34.59593,-58.441755,7,1,8,015
COMUNA 15,159,COLEGIO ECOS,SERRANO 923,-34.593348,-58.437438,4,0,4,015
COMUNA 15,159,COLEGIO PAIDEIA,ACEVEDO 566,-34.596807,-58.438754,3,0,3,015
COMUNA 15,159,JARDIN DE INFANTES N° 3 2,AGUIRRE 752,-34.595505,-58.437748,4,0,4,015
COMUNA 15,159,CLUB FULGOR DE VILLA CRESPO,LOYOLA 828,-34.593253,-58.438128,3,0,3,015
COMUNA 15,159,CLUB VILLA MALCOM,CORDOBA AV 5064,-34.5911,-58.435062,4,3,7,015
COMUNA 15,160,ESC N°17 FRANCISCO DE VITORIA,JULIAN ALVAREZ 240,-34.601869,-58.438113,7,6,13,015
COMUNA 15,160,ESC N°2 FCO DESIDERIO HERRERA,CAMARGO 725,-34.5987,-58.441988,3,4,7,015
COMUNA 15,160,ESC N°21 ALTE SEGUNDO R STORNI,MARTINEZ ROSAS 1364,-34.596952,-58.451776,7,0,7,015
COMUNA 15,160,COLEGIO BUENOS AIRES,ACEVEDO 357,-34.598702,-58.441354,5,0,5,015
COMUNA 15,160,ESC N°16 GABRIELA MISTRAL,JULIAN ALVAREZ 123,-34.602806,-58.439374,6,0,6,015
COMUNA 15,160,ESC N°12 HERMINIA BRUMANA,FITZ ROY 171,-34.597127,-58.452639,9,0,9,015
COMUNA 15,160,CLUB ATLETICO ATLANTA,HUMBOLDT 540,-34.594168,-58.447009,13,2,15,015
COMUNA 15,160,ESC N°22 DR ROMULO S NAON,ARAOZ 234,-34.601087,-58.439042,6,0,6,015
COMUNA 15,160,INSTITUTO EDUCATIVO ALAS,LAVALLEJA 250,-34.601885,-58.436042,4,0,4,015
COMUNA 15,160,COLEGIO BUENOS AIRES - GIMNASIO,ACEVEDO 371,-34.59854,-58.441149,6,0,6,015
COMUNA 15,161,ESC N°6 DELFIN JIJENA,OLAYA 1565,-34.602968,-58.446379,11,0,11,015
COMUNA 15,161,ESC N°16 ANDRES FERREYRA,CNEL APOLINARIO FIGUEROA 661,-34.606454,-58.448799,7,4,11,015
COMUNA 15,161,ESC N°21 EMILIO RAUL OLIVE,ROJAS 1554,-34.604104,-58.450158,7,0,7,015
COMUNA 15,161,INST REGINA VIRGINUM ADORATRICES,HONORIO  PUEYRREDON 1339,-34.605095,-58.447178,13,3,16,015
COMUNA 15,161,ASOC GRAL BENITO NAZAR,ANTEZANA 340,-34.605132,-58.444913,5,0,5,015
COMUNA 15,161,ESC N°11 DR ENRIQUE MOSCA,CASAFOUST 761,-34.599828,-58.456451,6,0,6,015
COMUNA 15,161,ESC N° 16 ANDRES FERREYRA - COMEDOR,LUIS VIALE 654,-34.605646,-58.449286,8,0,8,015
COMUNA 15,162,ESC N°10 REP DEL ECUADOR,ESPINOSA 2547,-34.600951,-58.467711,4,0,4,015
COMUNA 15,162,ESC N°20 REP DE HONDURAS,ELCANO AV 4861,-34.592055,-58.467585,3,3,6,015
COMUNA 15,162,ESC N°13 PCIA DE NEUQUEN,ALTE F J SEGUI 2580,-34.59703,-58.460962,5,0,5,015
COMUNA 15,162,ESC N°15 PCIA DE MENDOZA,JUAN A GARCIA 1511,-34.601818,-58.465608,4,0,4,015
COMUNA 15,162,CLUB SOC Y DEP AÑASCO,GRAL M A RODRIGUEZ 2650,-34.597549,-58.462023,6,0,6,015
COMUNA 15,162,ESC N°1 FEDERICO GARCIA LORCA,CHORROARIN AV 305,-34.594742,-58.47688,3,3,6,015
COMUNA 15,162,ESC N°24 DR D VELEZ SARSFIELD,DEL CAMPO AV 1340,-34.590094,-58.467635,4,3,7,015
COMUNA 15,162,ESC N° 23 ALFREDO R BUFANO,GRAL M A RODRIGUEZ 2332,-34.5986,-58.457009,4,3,7,015
COMUNA 15,162,ASOC ATLETICA ARGENTINOS JUNIORS,PUNTA ARENAS 1271,-34.591473,-58.469666,10,0,10,015
COMUNA 15,162,ESC N° 20 DR JUAN AGUSTIN GARCIA,NICASIO ORONO 2131,-34.601882,-58.460832,4,0,4,015
COMUNA 15,163,ESC N°8 C DE MENDEZ CASARIEGO,NEWBERY JORGE AV 4436,-34.592209,-58.454433,7,0,7,015
COMUNA 15,163,ESC N°34 ING E MARTIN HERMITTE,AGUIRRE 1473,-34.589338,-58.443646,11,3,14,015
COMUNA 15,163,ESC N°14 DR LUIS AGOTE,NEWBERY JORGE AV 3664,-34.584484,-58.449345,8,0,8,015
COMUNA 15,163,SEDE COMUNAL N°15,BONPLAND 1271,-34.587121,-58.441756,3,0,3,015
COMUNA 15,163,ESC N°1 RUBEN DARIO,OTERO 271,-34.59268,-58.452834,7,3,10,015
COMUNA 15,164,ESC N°18 CABILDO DE BUENOS AIRES,LACROZE FEDERICO AV 3839,-34.583714,-58.453136,4,2,6,015
COMUNA 15,164,ARGENTINA SCHOOL,GIRIBONE 867 ,-34.580554,-58.454997,5,0,5,015
COMUNA 15,164,ESC N°32 GRAL JOSE DE SAN MARTIN,TEODORO GARCIA 3871,-34.583588,-58.45442,8,8,16,015
COMUNA 15,164,ESC DEL SIGLO NUEVO,OLLEROS 3855,-34.584293,-58.452092,6,0,6,015
COMUNA 15,164,INST SANTA TERESA DE LOS ANDES,CHARLONE 753,-34.581862,-58.454124,4,0,4,015
COMUNA 15,164,JARDIN DE INFANTES COMUN N° 3,OLLEROS 3621,-34.582325,-58.450922,4,0,4,015
COMUNA 15,164,ESPACIO CULTURAL CARLOS GARDEL,OLLEROS 3640,-34.582529,-58.450913,4,0,4,015
COMUNA 15,165,ESC N°2 GRAL MARIANO ACHA,ROSETI 1450,-34.581831,-58.462625,9,2,11,015
COMUNA 15,165,ESC N°26 JOSE MARMOL,CARBAJAL 4019,-34.576953,-58.469204,5,3,8,015
COMUNA 15,165,INST C ESTRADA DE MARTINEZ,DEL CAMPO AV 1653,-34.587495,-58.470628,6,0,6,015
COMUNA 15,165,ESC N°4 GRAL J ANTONIO LAVALLEJA,14 DE JULIO 546,-34.587389,-58.463656,6,0,6,015
COMUNA 15,165,INST EDUC DUAYEN,BALLIVIAN 2230,-34.578683,-58.474397,3,0,3,015
COMUNA 15,165,ESC INTEGRAL INTERDISCIPLINARIA N°14,TRIUNVIRATO AV 3626,-34.582182,-58.472496,5,0,5,015
COMUNA 15,165,PROGRAMA EDUC ADULTOS 2000,BALLIVIAN 2329,-34.578672,-58.476001,3,0,3,015
COMUNA 15,165,INST PARROQUIAL SAN ROQUE,CHARLONE 1866,-34.580572,-58.468116,7,2,9,015
COMUNA 15,165,ESC N°3 ING ALVAREZ CONDARCO,GIRARDOT 1946,-34.585067,-58.471415,6,0,6,015
COMUNA 15,165,ESC N° 18 CECILIA MARIA DE CANO,GIRIBONE 1961,-34.57938,-58.469075,3,0,3,015
COMUNA 15,165,UTN INST NAC SUP DEL PROF TECNICO,TRIUNVIRATO AV 3174,-34.584008,-58.466972,4,0,4,015
COMUNA 15,166,ESC N°5 ENRIQUE DE VEDIA,COMBATIENTES DE MALVINAS AV 3234,-34.582918,-58.473323,5,0,5,015
COMUNA 15,166,ESC N°27 PETRONILA RODRIGUEZ,ANDONAEGUI 1532,-34.584946,-58.481908,4,0,4,015
COMUNA 15,166,INST EDUC SANTA TERESITA,QUIROS 2941,-34.589863,-58.476191,10,0,10,015
COMUNA 15,166,ASOC FOM PARQUE CHAS,BAUNESS 1486,-34.58419,-58.480127,8,0,8,015
COMUNA 15,166,CLUB SOC Y DEP AGRONOMIA CENTRAL,BAUNESS 958,-34.589479,-58.474609,10,0,10,015
COMUNA 15,166,CLUB SABER,LLERENA 2727,-34.58662,-58.476443,10,4,14,015
COMUNA 15,167,ESC N°25 CARMEN SONDA DE PANDOLFINI,SAN MARTIN AV 5021,-34.597239,-58.488875,5,0,5,015
COMUNA 15,167,ESC N°22 AGRONOMIA,DE LOS CONSTITUYENTES AV 3100,-34.591152,-58.478306,6,3,9,015
COMUNA 15,167,ESC N°3 GRECIA,CONDARCO 3984,-34.590121,-58.495181,4,0,4,015
COMUNA 15,167,ESC N°4 CNEL MAYOR ALVAREZ THOMAS,TERRADA 3983,-34.591025,-58.496062,5,0,5,015
COMUNA 15,167,ESC N° 11 CONGRESO DE TUCUMAN,P MORAN 2899,-34.592616,-58.49611,3,0,3,015
COMUNA 15,167,CLUB BIBLIOTECA ARTIGAS,NAVARRO 2544,-34.591782,-58.490882,7,0,7,015
COMUNA 15,167,INST PARROQUIAL NTRA SRA DE LA UNIDAD,ARTIGAS 3575,-34.59171,-58.490151,3,0,3,015
COMUNA 15,167,CLUB EL TALAR,NUEVA YORK 2944,-34.591844,-58.498166,4,0,4,015